,Transaction Number,Date,Description,Memo,Amount Debit,Amount Credit,Balance,Check Number,Fees,Category
0,20230912000000[-6:CST]*2.05*501**Interest paid,09/12/2023,Interest paid,,,2.05,25279.23,,0.0,Deposit
1,20230912000000[-6:CST]*-7.78*0**XX3498 POS WITHDRAWAL. SHELL SERVICE S B URLINGAME CA 86200201 231709,09/12/2023,XX3498 POS WITHDRAWAL. SHELL SERVICE S B URLINGAME CA 86200201 231709,,-7.78,,25277.18,,0.0,Travel
2,20230912000000[-6:CST]*-4.25*0**XX3498 POS PURCHASE AT PARKING METER - S ANTA ROSA CA 88701134 966518,09/12/2023,XX3498 POS PURCHASE AT PARKING METER - S ANTA ROSA CA 88701134 966518,,-4.25,,25284.96,,0.0,Travel
3,20230911000000[-6:CST]*-38.52*0**XX3498 POS WITHDRAWAL. WHOLEFDS 20955 CU PERTINO CA 22308002 113875,09/11/2023,XX3498 POS WITHDRAWAL. WHOLEFDS 20955 CU PERTINO CA 22308002 113875,,-38.52,,25289.21,,0.0,Travel
4,20230911000000[-6:CST]*-19.22*0**XX3498 POS WITHDRAWAL. COMMON SAGE SAN F RANCISCO CA 7875CL01 325371000698,09/11/2023,XX3498 POS WITHDRAWAL. COMMON SAGE SAN F RANCISCO CA 7875CL01 325371000698,,-19.22,,25327.73,,0.0,Travel
5,20230911000000[-6:CST]*-7.87*0**XX3498 POS WITHDRAWAL. VALERO 116 SEBAST OPOL CA 85770701 940680,09/11/2023,XX3498 POS WITHDRAWAL. VALERO 116 SEBAST OPOL CA 85770701 940680,,-7.87,,25346.95,,0.0,Travel
6,20230911000000[-6:CST]*-4.70*0**XX3498 POS PURCHASE AT ISU DESIGN CAFE A MES IA 75726922 662037,09/11/2023,XX3498 POS PURCHASE AT ISU DESIGN CAFE A MES IA 75726922 662037,,-4.7,,25354.82,,0.0,Food & Drink
7,20230908000000[-6:CST]*-24.97*0**XX3498 POS PURCHASE AT KWIK STOP LIQUOR AMES IA 13300906 868504,09/08/2023,XX3498 POS PURCHASE AT KWIK STOP LIQUOR AMES IA 13300906 868504,,-24.97,,25359.52,,0.0,Food & Drink
8,20230908000000[-6:CST]*108.00*501**IOWA STATE UNIVE PAYMENT 498061243-I_DEG,09/08/2023,IOWA STATE UNIVE PAYMENT 498061243-I_DEG,,,108.0,25384.49,,0.0,Deposit
9,20230907000000[-6:CST]*-12.00*0**XX3498 POS WITHDRAWAL. HY VEE 1013 AMES IA 1 053354,09/07/2023,XX3498 POS WITHDRAWAL. HY VEE 1013 AMES IA 1 053354,,-12.0,,25276.49,,0.0,Groceries
10,20230906000000[-6:CST]*-1957.92*0**CHASE CREDIT CRD AUTOPAY 000000000177463,09/06/2023,CHASE CREDIT CRD AUTOPAY 000000000177463,,-1957.92,,25288.49,,0.0,Bills & Utilities
11,20230905000000[-6:CST]*-712.75*0**IBMC ACH PMTS XXXXXX2430,09/05/2023,IBMC ACH PMTS XXXXXX2430,,-712.75,,27246.41,,0.0,Home
12,20230905000000[-6:CST]*-55.00*0**XX3498 POS PURCHASE AT SQ *LONDON UNDER Ames IA 28183776 413927,09/05/2023,XX3498 POS PURCHASE AT SQ *LONDON UNDER Ames IA 28183776 413927,,-55.0,,27959.16,,0.0,Food & Drink
13,20230905000000[-6:CST]*-33.42*0**XX3498 POS WITHDRAWAL. WAL-MART #749 AME S IA 600001 040547,09/05/2023,XX3498 POS WITHDRAWAL. WAL-MART #749 AME S IA 600001 040547,,-33.42,,28014.16,,0.0,Groceries
14,20230905000000[-6:CST]*-23.00*0**XX3498 POS PURCHASE AT GOODWILL AMES AME S IA 99700094 409053,09/05/2023,XX3498 POS PURCHASE AT GOODWILL AMES AME S IA 99700094 409053,,-23.0,,28047.58,,0.0,Home
15,20230905000000[-6:CST]*-20.00*0**XX3498 POS PURCHASE AT SQ *ACPS Ames IA 38030178 311137,09/05/2023,XX3498 POS PURCHASE AT SQ *ACPS Ames IA 38030178 311137,,-20.0,,28070.58,,0.0,Entertainment
16,20230905000000[-6:CST]*-4.38*0**XX3498 POS WITHDRAWAL. CASEYS STORE 43 A MES IA 600001 053374,09/05/2023,XX3498 POS WITHDRAWAL. CASEYS STORE 43 A MES IA 600001 053374,,-4.38,,28090.58,,0.0,Gas
17,20230901000000[-6:CST]*-36.28*0**XX3498 POS WITHDRAWAL. Wal-Mart Super C AMES IA 07490050 324449910941,09/01/2023,XX3498 POS WITHDRAWAL. Wal-Mart Super C AMES IA 07490050 324449910941,,-36.28,,28094.96,,0.0,Groceries
18,20230901000000[-6:CST]*-9.49*0**XX3498 POS PURCHASE AT SQ *DAYTIME Ames IA 46866393 560102,09/01/2023,XX3498 POS PURCHASE AT SQ *DAYTIME Ames IA 46866393 560102,,-9.49,,28131.24,,0.0,Food & Drink
19,20230831000000[-6:CST]*-14.44*0**XX3498 POS PURCHASE AT SQ *1+1 RESTAURA AMES IA 37185848 369364,08/31/2023,XX3498 POS PURCHASE AT SQ *1+1 RESTAURA AMES IA 37185848 369364,,-14.44,,28140.73,,0.0,Food & Drink
20,20230831000000[-6:CST]*-20.00*0**RESEARCH FEE,08/31/2023,RESEARCH FEE,,-20.0,,28155.17,,0.0,Personal
21,20230831000000[-6:CST]*-1.40*0**SALES TAX,08/31/2023,SALES TAX,,-1.4,,28175.17,,0.0,Personal
22,20230831000000[-6:CST]*37.86*501**CITY OF AMES PAYROLL XXXXX4201,08/31/2023,CITY OF AMES PAYROLL XXXXX4201,,,37.86,28176.57,,0.0,Deposit
23,20230830000000[-6:CST]*-7.50*0**XX3498 POS PURCHASE AT WILD WATER CAR W AMES IA 04089192 592747,08/30/2023,XX3498 POS PURCHASE AT WILD WATER CAR W AMES IA 04089192 592747,,-7.5,,28138.71,,0.0,Automotive
24,20230829000000[-6:CST]*-47.00*0**XX3498 POS WITHDRAWAL. HY VEE 1018 AMES IA 1 601640,08/29/2023,XX3498 POS WITHDRAWAL. HY VEE 1018 AMES IA 1 601640,,-47.0,,28146.21,,0.0,Groceries
25,20230824000000[-6:CST]*-99.44*0**CITY OF AMES UT BILL 002629810006826,08/24/2023,CITY OF AMES UT BILL 002629810006826,,-99.44,,28193.21,,0.0,Bills & Utilities
26,20230824000000[-6:CST]*-12.50*0**XX3498 POS WITHDRAWAL. MCDONALD'S M2021 AMES IA 81545316 459963,08/24/2023,XX3498 POS WITHDRAWAL. MCDONALD'S M2021 AMES IA 81545316 459963,,-12.5,,28292.65,,0.0,Food & Drink
27,20230823000000[-6:CST]*-155.06*0**FARMERS INS EFT PYMT mXXXXX5868,08/23/2023,FARMERS INS EFT PYMT mXXXXX5868,,-155.06,,28305.15,,0.0,Automotive
28,20230822000000[-6:CST]*-137.83*0**CITY OF AMES UT BILL 002819790003022,08/22/2023,CITY OF AMES UT BILL 002819790003022,,-137.83,,28460.21,,0.0,Bills & Utilities
29,20230822000000[-6:CST]*-23.00*0**XX3498 POS WITHDRAWAL. WHEATSFIELD COOP AMES IA 68087201 754206,08/22/2023,XX3498 POS WITHDRAWAL. WHEATSFIELD COOP AMES IA 68087201 754206,,-23.0,,28598.04,,0.0,Groceries
30,20230822000000[-6:CST]*-12.84*0**XX3498 POS WITHDRAWAL. HY VEE 1013 AMES IA 1 735559,08/22/2023,XX3498 POS WITHDRAWAL. HY VEE 1013 AMES IA 1 735559,,-12.84,,28621.04,,0.0,Groceries
31,20230821000000[-6:CST]*-7835.45*0**IOWA STATE UNIV. ACH PYMT 498061243W,08/21/2023,IOWA STATE UNIV. ACH PYMT 498061243W,,-7835.45,,28633.88,,0.0,Education
32,20230821000000[-6:CST]*-18.39*0**Alliant - IPL PAYMENT 0061467186,08/21/2023,Alliant - IPL PAYMENT 0061467186,,-18.39,,36469.33,,0.0,Bills & Utilities
33,20230821000000[-6:CST]*-58.79*0**XX3498 POS WITHDRAWAL. WAL-MART #749 AME S IA 600001 035274,08/21/2023,XX3498 POS WITHDRAWAL. WAL-MART #749 AME S IA 600001 035274,,-58.79,,36487.72,,0.0,Groceries
34,20230821000000[-6:CST]*-41.03*0**XX3498 POS WITHDRAWAL. WAL-MART #0749 AM ES IA 24074901 643426,08/21/2023,XX3498 POS WITHDRAWAL. WAL-MART #0749 AM ES IA 24074901 643426,,-41.03,,36546.51,,0.0,Groceries
35,20230821000000[-6:CST]*-41.00*0**XX3498 POS PURCHASE AT O DONNELL ACE HA AMES IA 71002463 713816,08/21/2023,XX3498 POS PURCHASE AT O DONNELL ACE HA AMES IA 71002463 713816,,-41.0,,36587.54,,0.0,Home
36,20230821000000[-6:CST]*-25.62*0**XX3498 POS WITHDRAWAL. WAL-MART #749 AME S IA 600001 010485,08/21/2023,XX3498 POS WITHDRAWAL. WAL-MART #749 AME S IA 600001 010485,,-25.62,,36628.54,,0.0,Groceries
37,20230821000000[-6:CST]*-7.80*0**XX3498 POS PURCHASE AT CULVERS OF AMES A MES IA 00731202 544635,08/21/2023,XX3498 POS PURCHASE AT CULVERS OF AMES A MES IA 00731202 544635,,-7.8,,36654.16,,0.0,Food & Drink
38,20230818000000[-6:CST]*-21.21*0**XX3498 POS WITHDRAWAL. WALGREENS 2719 G AMES IA 12108T22 106201,08/18/2023,XX3498 POS WITHDRAWAL. WALGREENS 2719 G AMES IA 12108T22 106201,,-21.21,,36661.96,,0.0,Groceries
39,20230817000000[-6:CST]*-24.60*0**CLUB FEES PLANET FIT 515-450-5351,08/17/2023,CLUB FEES PLANET FIT 515-450-5351,,-24.6,,36683.17,,0.0,Personal
40,20230817000000[-6:CST]*-50.65*0**XX3498 POS WITHDRAWAL. HY VEE 1018 AMES IA 1 158689,08/17/2023,XX3498 POS WITHDRAWAL. HY VEE 1018 AMES IA 1 158689,,-50.65,,36707.77,,0.0,Groceries
41,20230817000000[-6:CST]*5.00*501**XX3498 CHECK DEPOSIT.. 405 5TH ST AMES I A IA000619 007800,08/17/2023,XX3498 CHECK DEPOSIT.. 405 5TH ST AMES I A IA000619 007800,,,5.0,36758.42,,0.0,Deposit
42,20230816000000[-6:CST]*-8.34*0**XX3498 POS WITHDRAWAL. MCDONALD'S M2045 AMES IA 81553413 067257,08/16/2023,XX3498 POS WITHDRAWAL. MCDONALD'S M2045 AMES IA 81553413 067257,,-8.34,,36753.42,,0.0,Food & Drink
43,20230815000000[-6:CST]*-309.44*0**VERIZON WIRELESS PAYMENTS 05885909720000 1,08/15/2023,VERIZON WIRELESS PAYMENTS 05885909720000 1,,-309.44,,36761.76,,0.0,Bills & Utilities
44,20230815000000[-6:CST]*-22.03*0**XX3498 POS PURCHASE AT O DONNELL ACE HA AMES IA 72001438 522503,08/15/2023,XX3498 POS PURCHASE AT O DONNELL ACE HA AMES IA 72001438 522503,,-22.03,,37071.2,,0.0,Home
45,20230814000000[-6:CST]*-23.29*0**XX3498 POS WITHDRAWAL. Wal-Mart Super C AMES IA 07490050 322607442017,08/14/2023,XX3498 POS WITHDRAWAL. Wal-Mart Super C AMES IA 07490050 322607442017,,-23.29,,37093.23,,0.0,Groceries
46,20230810000000[-6:CST]*-40.00*0**VENMO PAYMENT 1028704269663,08/10/2023,VENMO PAYMENT 1028704269663,,-40.0,,37116.52,,0.0,Personal
47,20230809000000[-6:CST]*-37.60*0**XX3498 POS WITHDRAWAL. HY VEE 1013 AMES IA 1 582284,08/09/2023,XX3498 POS WITHDRAWAL. HY VEE 1013 AMES IA 1 582284,,-37.6,,37156.52,,0.0,Groceries
48,20230809000000[-6:CST]*-13.00*0**XX3498 POS PURCHASE AT O DONNELL ACE HA AMES IA 73000732 207540,08/09/2023,XX3498 POS PURCHASE AT O DONNELL ACE HA AMES IA 73000732 207540,,-13.0,,37194.12,,0.0,Home
49,20230808000000[-6:CST]*2.22*501**Interest paid,08/08/2023,Interest paid,,,2.22,37207.12,,0.0,Deposit
50,20230808000000[-6:CST]*-78.71*0**XX3498 POS WITHDRAWAL. HY VEE 1013 AMES IA 1 208919,08/08/2023,XX3498 POS WITHDRAWAL. HY VEE 1013 AMES IA 1 208919,,-78.71,,37204.9,,0.0,Groceries
51,20230807000000[-6:CST]*-2620.66*0**CHASE CREDIT CRD AUTOPAY 000000000340848,08/07/2023,CHASE CREDIT CRD AUTOPAY 000000000340848,,-2620.66,,37283.61,,0.0,Bills & Utilities
52,20230807000000[-6:CST]*-712.75*0**IBMC ACH PMTS XXXXXX2430,08/07/2023,IBMC ACH PMTS XXXXXX2430,,-712.75,,39904.27,,0.0,Home
53,20230807000000[-6:CST]*-30.00*0**XX3498 POS WITHDRAWAL. HY VEE 1018 AMES IA 1 038332,08/07/2023,XX3498 POS WITHDRAWAL. HY VEE 1018 AMES IA 1 038332,,-30.0,,40617.02,,0.0,Groceries
54,20230807000000[-6:CST]*-20.00*0**XX3498 POS PURCHASE AT SQ *ALLUVIAL BRE Ames IA 73604704 911365,08/07/2023,XX3498 POS PURCHASE AT SQ *ALLUVIAL BRE Ames IA 73604704 911365,,-20.0,,40647.02,,0.0,Food & Drink
55,20230804000000[-6:CST]*-6.93*0**XX3498 POS WITHDRAWAL. MCDONALD'S M2021 AMES IA 81545316 776999,08/04/2023,XX3498 POS WITHDRAWAL. MCDONALD'S M2021 AMES IA 81545316 776999,,-6.93,,40667.02,,0.0,Food & Drink
56,20230804000000[-6:CST]*257.96*501**DONNELLEY FINANC DIRECT DEP 928929017126 L5Z,08/04/2023,DONNELLEY FINANC DIRECT DEP 928929017126 L5Z,,,257.96,40673.95,,0.0,Deposit
57,20230803000000[-6:CST]*-25.19*0**XX3498 POS WITHDRAWAL. HY VEE 1018 AMES IA 1 012818,08/03/2023,XX3498 POS WITHDRAWAL. HY VEE 1018 AMES IA 1 012818,,-25.19,,40415.99,,0.0,Groceries
58,20230803000000[-6:CST]*-14.00*0**XX3498 POS WITHDRAWAL. HY VEE 1018 AMES IA 1 011719,08/03/2023,XX3498 POS WITHDRAWAL. HY VEE 1018 AMES IA 1 011719,,-14.0,,40441.18,,0.0,Groceries
59,20230803000000[-6:CST]*-8.52*0**XX3498 POS PURCHASE AT TACO BELL #30421 AMES IA 07092145 584775,08/03/2023,XX3498 POS PURCHASE AT TACO BELL #30421 AMES IA 07092145 584775,,-8.52,,40455.18,,0.0,Food & Drink
60,20230802000000[-6:CST]*-46.71*0**XX3498 POS PURCHASE AT SQ *WOK N ROLL Am es IA 67922260 287783,08/02/2023,XX3498 POS PURCHASE AT SQ *WOK N ROLL Am es IA 67922260 287783,,-46.71,,40463.7,,0.0,Food & Drink
61,20230802000000[-6:CST]*-25.91*0**XX3498 POS WITHDRAWAL. HY VEE 1013 AMES IA 1 360225,08/02/2023,XX3498 POS WITHDRAWAL. HY VEE 1013 AMES IA 1 360225,,-25.91,,40510.41,,0.0,Groceries
62,20230801000000[-6:CST]*-19.30*0**XX3498 POS WITHDRAWAL. HY VEE 1018 AMES IA 1 302157,08/01/2023,XX3498 POS WITHDRAWAL. HY VEE 1018 AMES IA 1 302157,,-19.3,,40536.32,,0.0,Groceries
63,20230801000000[-6:CST]*-13.00*0**XX3498 POS WITHDRAWAL. HY VEE 1018 AMES IA 1 299936,08/01/2023,XX3498 POS WITHDRAWAL. HY VEE 1018 AMES IA 1 299936,,-13.0,,40555.62,,0.0,Groceries
64,20230731000000[-6:CST]*-24.73*0**Alliant - IPL PAYMENT 3836938783,07/31/2023,Alliant - IPL PAYMENT 3836938783,,-24.73,,40568.62,,0.0,Bills & Utilities
65,20230731000000[-6:CST]*-48.46*0**XX3498 POS WITHDRAWAL. Wal-Mart Super C AMES IA 07490048 321134122907,07/31/2023,XX3498 POS WITHDRAWAL. Wal-Mart Super C AMES IA 07490048 321134122907,,-48.46,,40593.35,,0.0,Groceries
66,20230731000000[-6:CST]*-8.29*0**XX3498 POS PURCHASE AT NORTH GRAND CINE AMES IA 85052617 122049,07/31/2023,XX3498 POS PURCHASE AT NORTH GRAND CINE AMES IA 85052617 122049,,-8.29,,40641.81,,0.0,Entertainment
67,20230728000000[-6:CST]*-802.00*0**DHS CSRU IOW DHS IOWDHS013089124,07/28/2023,DHS CSRU IOW DHS IOWDHS013089124,,-802.0,,40650.1,,0.0,Bills & Utilities
68,20230728000000[-6:CST]*-0.29*0**DHS CSRU conv fee IOWDHS013089125,07/28/2023,DHS CSRU conv fee IOWDHS013089125,,-0.29,,41452.1,,0.0,Bills & Utilities
69,20230728000000[-6:CST]*-38.30*0**XX3498 POS WITHDRAWAL. Wal-Mart Super C AMES IA 07490044 320989612888,07/28/2023,XX3498 POS WITHDRAWAL. Wal-Mart Super C AMES IA 07490044 320989612888,,-38.3,,41452.39,,0.0,Groceries
70,20230727000000[-6:CST]*-92.79*0**CITY OF AMES UT BILL 002629810006826,07/27/2023,CITY OF AMES UT BILL 002629810006826,,-92.79,,41490.69,,0.0,Bills & Utilities
71,20230727000000[-6:CST]*-76.58*0**XX3498 POS WITHDRAWAL. WAL-MART #0749 AM ES IA 24074901 144657,07/27/2023,XX3498 POS WITHDRAWAL. WAL-MART #0749 AM ES IA 24074901 144657,,-76.58,,41583.48,,0.0,Groceries
72,20230726000000[-6:CST]*-20.09*0**Alliant - IPL PAYMENT 0061467186,07/26/2023,Alliant - IPL PAYMENT 0061467186,,-20.09,,41660.06,,0.0,Bills & Utilities
73,20230726000000[-6:CST]*-20.00*0**XX3498 POS PURCHASE AT SPORTSMANS LOUNG Ames IA 20819588 090637,07/26/2023,XX3498 POS PURCHASE AT SPORTSMANS LOUNG Ames IA 20819588 090637,,-20.0,,41680.15,,0.0,Food & Drink
74,20230725000000[-6:CST]*-44.54*0**XX3498 POS WITHDRAWAL. Wal-Mart Super C AMES IA 07490047 320684321560,07/25/2023,XX3498 POS WITHDRAWAL. Wal-Mart Super C AMES IA 07490047 320684321560,,-44.54,,41700.15,,0.0,Groceries
75,20230725000000[-6:CST]*-7.00*0**XX3498 POS PURCHASE AT O DONNELL ACE HA AMES IA 78002682 191808,07/25/2023,XX3498 POS PURCHASE AT O DONNELL ACE HA AMES IA 78002682 191808,,-7.0,,41744.69,,0.0,Home
76,20230724000000[-6:CST]*-155.11*0**FARMERS INS EFT PYMT mXXXXX5868,07/24/2023,FARMERS INS EFT PYMT mXXXXX5868,,-155.11,,41751.69,,0.0,Automotive
77,20230724000000[-6:CST]*-146.72*0**CITY OF AMES UT BILL 002819790003022,07/24/2023,CITY OF AMES UT BILL 002819790003022,,-146.72,,41906.8,,0.0,Bills & Utilities
78,20230724000000[-6:CST]*-136.89*0**XX3498 POS WITHDRAWAL. HY VEE 1018 AMES IA 1 568337,07/24/2023,XX3498 POS WITHDRAWAL. HY VEE 1018 AMES IA 1 568337,,-136.89,,42053.52,,0.0,Groceries
79,20230724000000[-6:CST]*-25.00*0**XX3498 POS PURCHASE AT SQ *ACPS Ames IA 86707234 280958,07/24/2023,XX3498 POS PURCHASE AT SQ *ACPS Ames IA 86707234 280958,,-25.0,,42190.41,,0.0,Entertainment
80,20230724000000[-6:CST]*-9.28*0**XX3498 POS WITHDRAWAL. BP#1988898RUTHV RUTHVEN IA 57114801 500589,07/24/2023,XX3498 POS WITHDRAWAL. BP#1988898RUTHV RUTHVEN IA 57114801 500589,,-9.28,,42215.41,,0.0,Gas
81,20230724000000[-6:CST]*-200.00*0**Miscellaneous Debit,07/24/2023,Miscellaneous Debit,,-200.0,,42224.69,,0.0,Personal
82,20230721000000[-6:CST]*-89.69*0**XX3498 POS WITHDRAWAL. SUNSHINE FOODS MI LFORD IA 48175301 201398,07/21/2023,XX3498 POS WITHDRAWAL. SUNSHINE FOODS MI LFORD IA 48175301 201398,,-89.69,,42424.69,,0.0,Groceries
83,20230721000000[-6:CST]*-26.49*0**XX3498 POS WITHDRAWAL. WAL-MART #749 AME S IA 600001 011386,07/21/2023,XX3498 POS WITHDRAWAL. WAL-MART #749 AME S IA 600001 011386,,-26.49,,42514.38,,0.0,Groceries
84,20230720000000[-6:CST]*-45.16*0**XX3498 POS WITHDRAWAL. HY VEE 1018 AMES IA 1 905968,07/20/2023,XX3498 POS WITHDRAWAL. HY VEE 1018 AMES IA 1 905968,,-45.16,,42540.87,,0.0,Groceries
85,20230720000000[-6:CST]*-22.46*0**XX3498 POS PURCHASE AT O DONNELL ACE HA AMES IA 79001647 207495,07/20/2023,XX3498 POS PURCHASE AT O DONNELL ACE HA AMES IA 79001647 207495,,-22.46,,42586.03,,0.0,Home
86,20230720000000[-6:CST]*-7.80*0**XX3498 POS PURCHASE AT CULVERS OF AMES A MES IA 00600940 213831,07/20/2023,XX3498 POS PURCHASE AT CULVERS OF AMES A MES IA 00600940 213831,,-7.8,,42608.49,,0.0,Food & Drink
87,20230719000000[-6:CST]*-13.25*0**XX3498 POS WITHDRAWAL. HY VEE 1018 AMES IA 1 597346,07/19/2023,XX3498 POS WITHDRAWAL. HY VEE 1018 AMES IA 1 597346,,-13.25,,42616.29,,0.0,Groceries
88,20230718000000[-6:CST]*-72.23*0**XX3498 POS WITHDRAWAL. WAL-MART #749 AME S IA 600001 006932,07/18/2023,XX3498 POS WITHDRAWAL. WAL-MART #749 AME S IA 600001 006932,,-72.23,,42629.54,,0.0,Groceries
89,20230718000000[-6:CST]*-3.04*0**XX3498 POS WITHDRAWAL. WHEATSFIELD COOP AMES IA 68087201 039534,07/18/2023,XX3498 POS WITHDRAWAL. WHEATSFIELD COOP AMES IA 68087201 039534,,-3.04,,42701.77,,0.0,Groceries
90,20230717000000[-6:CST]*-24.60*0**CLUB FEES PLANET FIT 515-450-5351,07/17/2023,CLUB FEES PLANET FIT 515-450-5351,,-24.6,,42704.81,,0.0,Personal
91,20230717000000[-6:CST]*-14.00*0**XX3498 POS PURCHASE AT CLATSOP COUNTY H ASTORIA OR 10000183 939915,07/17/2023,XX3498 POS PURCHASE AT CLATSOP COUNTY H ASTORIA OR 10000183 939915,,-14.0,,42729.41,,0.0,Travel
92,20230714000000[-6:CST]*-25.00*0**XX3498 ATM WITHDRAWAL. 730 Bond St Suite B Astoria OR GM043083 004760,07/14/2023,XX3498 ATM WITHDRAWAL. 730 Bond St Suite B Astoria OR GM043083 004760,,-25.0,,42743.41,,0.0,Personal
93,20230714000000[-6:CST]*-3.00*0**ATM WITHDRAWAL FEE XX3498 ATM WITHDRAWAL . 730 Bond St Suite B Astoria OR GM0430,07/14/2023,ATM WITHDRAWAL FEE XX3498 ATM WITHDRAWAL . 730 Bond St Suite B Astoria OR GM0430,,-3.0,,42768.41,,0.0,Personal
94,20230713000000[-6:CST]*-298.80*0**VERIZON WIRELESS PAYMENTS 05885909720000 1,07/13/2023,VERIZON WIRELESS PAYMENTS 05885909720000 1,,-298.8,,42771.41,,0.0,Bills & Utilities
95,20230713000000[-6:CST]*-22.48*0**Alliant - IPL PAYMENT 3836938783,07/13/2023,Alliant - IPL PAYMENT 3836938783,,-22.48,,43070.21,,0.0,Bills & Utilities
96,20230711000000[-6:CST]*2.56*501**Interest paid,07/11/2023,Interest paid,,,2.56,43092.69,,0.0,Deposit
97,20230711000000[-6:CST]*-80.55*0**ASPEN WASTE SYST EFT PMT 8 00257691,07/11/2023,ASPEN WASTE SYST EFT PMT 8 00257691,,-80.55,,43090.13,,0.0,Bills & Utilities
98,20230710000000[-6:CST]*-16.15*0**XX3498 POS PURCHASE AT DENVER AIRPORT DE NVER CO 69880906 835910,07/10/2023,XX3498 POS PURCHASE AT DENVER AIRPORT DE NVER CO 69880906 835910,,-16.15,,43170.68,,0.0,Travel
99,20230710000000[-6:CST]*-5.52*0**XX3498 POS PURCHASE AT KATE'S CUP CLARKSTON WA 02000200 155214,07/10/2023,XX3498 POS PURCHASE AT KATE'S CUP CLARKSTON WA 02000200 155214,,-5.52,,43186.83,,0.0,Travel
100,20230707000000[-6:CST]*-15.79*0**XX3498 POS PURCHASE AT Taza Mediterrane Ames IA 13492545 420067,07/07/2023,XX3498 POS PURCHASE AT Taza Mediterrane Ames IA 13492545 420067,,-15.79,,43192.35,,0.0,Food & Drink
101,20230706000000[-6:CST]*-1793.23*0**CHASE CREDIT CRD AUTOPAY 000000000177222,07/06/2023,CHASE CREDIT CRD AUTOPAY 000000000177222,,-1793.23,,43208.14,,0.0,Bills & Utilities
102,20230706000000[-6:CST]*-24.00*0**XX3498 POS PURCHASE AT SQ *THE ANGRY IR AMES IA 36844497 572368,07/06/2023,XX3498 POS PURCHASE AT SQ *THE ANGRY IR AMES IA 36844497 572368,,-24.0,,45001.37,,0.0,Food & Drink
103,20230706000000[-6:CST]*-19.45*0**XX3498 POS WITHDRAWAL. HY VEE CLINIC 30 AMES IA 1 633170,07/06/2023,XX3498 POS WITHDRAWAL. HY VEE CLINIC 30 AMES IA 1 633170,,-19.45,,45025.37,,0.0,Groceries
104,20230706000000[-6:CST]*350.00*501**XX3498 CHECK DEPOSIT.. 405 5TH ST AMES I A IA000619 007015,07/06/2023,XX3498 CHECK DEPOSIT.. 405 5TH ST AMES I A IA000619 007015,,,350.0,45044.82,,0.0,Deposit
105,20230705000000[-6:CST]*-712.75*0**IBMC ACH PMTS XXXXXX2430,07/05/2023,IBMC ACH PMTS XXXXXX2430,,-712.75,,44694.82,,0.0,Home
106,20230705000000[-6:CST]*-71.85*0**XX3498 POS WITHDRAWAL. HY VEE 1013 AMES IA 1 008134,07/05/2023,XX3498 POS WITHDRAWAL. HY VEE 1013 AMES IA 1 008134,,-71.85,,45407.57,,0.0,Groceries
107,20230705000000[-6:CST]*-43.82*0**XX3498 POS WITHDRAWAL. MNRD-AMES 700 SE AMES IA 35335604 952981,07/05/2023,XX3498 POS WITHDRAWAL. MNRD-AMES 700 SE AMES IA 35335604 952981,,-43.82,,45479.42,,0.0,Home
108,20230705000000[-6:CST]*-11.64*0**XX3498 POS WITHDRAWAL. LOWE'S #581 AMES IA 001 185115,07/05/2023,XX3498 POS WITHDRAWAL. LOWE'S #581 AMES IA 001 185115,,-11.64,,45523.24,,0.0,Home
109,20230703000000[-6:CST]*-25.00*0**XX3498 POS PURCHASE AT SQ *ACPS Ames IA 63360526 816106,07/03/2023,XX3498 POS PURCHASE AT SQ *ACPS Ames IA 63360526 816106,,-25.0,,45534.88,,0.0,Entertainment
110,20230703000000[-6:CST]*-15.00*0**XX3498 POS PURCHASE AT GOODWILL AMES AME S IA 99700271 593954,07/03/2023,XX3498 POS PURCHASE AT GOODWILL AMES AME S IA 99700271 593954,,-15.0,,45559.88,,0.0,Home
111,20230630000000[-6:CST]*-45.00*0**XX3498 POS PURCHASE AT SQ *LONDON UNDER Ames IA 09591435 092593,06/30/2023,XX3498 POS PURCHASE AT SQ *LONDON UNDER Ames IA 09591435 092593,,-45.0,,45574.88,,0.0,Food & Drink
112,20230630000000[-6:CST]*-18.63*0**XX3498 POS WITHDRAWAL. KUMGO 1215R AME AMES IA 001 533934,06/30/2023,XX3498 POS WITHDRAWAL. KUM&GO 1215R AME AMES IA 001 533934,,-18.63,,45619.88,,0.0,Gas
113,20230630000000[-6:CST]*-10.35*0**XX3498 POS PURCHASE AT SQ *CORNBRED BAR Ames IA 14100378 176587,06/30/2023,XX3498 POS PURCHASE AT SQ *CORNBRED BAR Ames IA 14100378 176587,,-10.35,,45638.51,,0.0,Food & Drink
114,20230629000000[-6:CST]*-4000.00*1*1045*Check,06/29/2023,Check,,-4000.0,,45648.86,1045.0,0.0,Personal
115,20230629000000[-6:CST]*-16.00*0**XX3498 POS PURCHASE AT SQ *THE ANGRY IR Ames IA 28294924 014526,06/29/2023,XX3498 POS PURCHASE AT SQ *THE ANGRY IR Ames IA 28294924 014526,,-16.0,,49648.86,,0.0,Food & Drink
116,20230628000000[-6:CST]*-4.40*0**XX3498 POS PURCHASE AT THE ROASTERIE AME S IA 00400775 974832,06/28/2023,XX3498 POS PURCHASE AT THE ROASTERIE AME S IA 00400775 974832,,-4.4,,49664.86,,0.0,Food & Drink
117,20230627000000[-6:CST]*-58.72*0**CITY OF AMES UT BILL 002629810006826,06/27/2023,CITY OF AMES UT BILL 002629810006826,,-58.72,,49669.26,,0.0,Bills & Utilities
118,20230627000000[-6:CST]*-38.00*0**XX3498 POS WITHDRAWAL. WAL-MART #0749 AM ES IA 24074901 611350,06/27/2023,XX3498 POS WITHDRAWAL. WAL-MART #0749 AM ES IA 24074901 611350,,-38.0,,49727.98,,0.0,Groceries
119,20230627000000[-6:CST]*-17.11*0**XX3498 POS WITHDRAWAL. FAREWAY STORES # AMES IA 92405501 674900,06/27/2023,XX3498 POS WITHDRAWAL. FAREWAY STORES # AMES IA 92405501 674900,,-17.11,,49765.98,,0.0,Groceries
120,20230626000000[-6:CST]*-21.00*0**XX3498 POS PURCHASE AT THE SALVATION AR AMES IA 60744968 638433,06/26/2023,XX3498 POS PURCHASE AT THE SALVATION AR AMES IA 60744968 638433,,-21.0,,49783.09,,0.0,Home
121,20230626000000[-6:CST]*-19.85*0**XX3498 POS WITHDRAWAL. WAL-MART #0749 AM ES IA 24074901 186767,06/26/2023,XX3498 POS WITHDRAWAL. WAL-MART #0749 AM ES IA 24074901 186767,,-19.85,,49804.09,,0.0,Groceries
122,20230626000000[-6:CST]*-19.00*0**XX3498 POS WITHDRAWAL. WHEATSFIELD COOP AMES IA 68087201 341763,06/26/2023,XX3498 POS WITHDRAWAL. WHEATSFIELD COOP AMES IA 68087201 341763,,-19.0,,49823.94,,0.0,Groceries
123,20230626000000[-6:CST]*-18.00*0**XX3498 POS WITHDRAWAL. WAL-MART #0749 AM ES IA 24074901 071534,06/26/2023,XX3498 POS WITHDRAWAL. WAL-MART #0749 AM ES IA 24074901 071534,,-18.0,,49842.94,,0.0,Groceries
124,20230626000000[-6:CST]*-6.17*0**XX3498 POS PURCHASE AT O DONNELL ACE HA AMES IA 71001850 147008,06/26/2023,XX3498 POS PURCHASE AT O DONNELL ACE HA AMES IA 71001850 147008,,-6.17,,49860.94,,0.0,Home
125,20230623000000[-6:CST]*-589.86*0**FARMERS INS EFT PYMT mXXXXX5868,06/23/2023,FARMERS INS EFT PYMT mXXXXX5868,,-589.86,,49867.11,,0.0,Automotive
126,20230623000000[-6:CST]*-95.42*0**CITY OF AMES UT BILL 002819790003022,06/23/2023,CITY OF AMES UT BILL 002819790003022,,-95.42,,50456.97,,0.0,Bills & Utilities
127,20230623000000[-6:CST]*-26.35*0**XX3498 POS PURCHASE AT EL AZTECA AMES IA 99800648 375718,06/23/2023,XX3498 POS PURCHASE AT EL AZTECA AMES IA 99800648 375718,,-26.35,,50552.39,,0.0,Food & Drink
128,20230623000000[-6:CST]*-13.95*0**XX3498 POS WITHDRAWAL. FAREWAY STORES # AMES IA 92405501 148100,06/23/2023,XX3498 POS WITHDRAWAL. FAREWAY STORES # AMES IA 92405501 148100,,-13.95,,50578.74,,0.0,Groceries
129,20230622000000[-6:CST]*-36.00*0**XX3498 POS WITHDRAWAL. WAL-MART #749 AME S IA 600001 030498,06/22/2023,XX3498 POS WITHDRAWAL. WAL-MART #749 AME S IA 600001 030498,,-36.0,,50592.69,,0.0,Groceries
130,20230622000000[-6:CST]*-23.97*0**XX3498 POS PURCHASE AT KWIK STOP LIQUOR AMES IA 65122807 168576,06/22/2023,XX3498 POS PURCHASE AT KWIK STOP LIQUOR AMES IA 65122807 168576,,-23.97,,50628.69,,0.0,Food & Drink
131,20230622000000[-6:CST]*-15.56*0**XX3498 POS WITHDRAWAL. WAL-MART #749 AME S IA 600001 051035,06/22/2023,XX3498 POS WITHDRAWAL. WAL-MART #749 AME S IA 600001 051035,,-15.56,,50652.66,,0.0,Groceries
132,20230622000000[-6:CST]*-13.28*0**XX3498 POS WITHDRAWAL. WALGREENS 2719 G AMES IA 12108T21 035673,06/22/2023,XX3498 POS WITHDRAWAL. WALGREENS 2719 G AMES IA 12108T21 035673,,-13.28,,50668.22,,0.0,Groceries
133,20230621000000[-6:CST]*-33.17*0**Alliant - IPL PAYMENT 0061467186,06/21/2023,Alliant - IPL PAYMENT 0061467186,,-33.17,,50681.5,,0.0,Bills & Utilities
134,20230620000000[-6:CST]*-24.60*0**CLUB FEES PLANET FIT 515-450-5351,06/20/2023,CLUB FEES PLANET FIT 515-450-5351,,-24.6,,50714.67,,0.0,Personal
135,20230620000000[-6:CST]*-39.21*0**XX3498 POS WITHDRAWAL. Wal-Mart Super C AMES IA 07490048 316908810671,06/20/2023,XX3498 POS WITHDRAWAL. Wal-Mart Super C AMES IA 07490048 316908810671,,-39.21,,50739.27,,0.0,Groceries
136,20230616000000[-6:CST]*-802.00*0**DHS CSRU IOW DHS IOWDHS012923202,06/16/2023,DHS CSRU IOW DHS IOWDHS012923202,,-802.0,,50778.48,,0.0,Bills & Utilities
137,20230616000000[-6:CST]*-0.29*0**DHS CSRU conv fee IOWDHS012923203,06/16/2023,DHS CSRU conv fee IOWDHS012923203,,-0.29,,51580.48,,0.0,Bills & Utilities
138,20230614000000[-6:CST]*-400.00*0**VENMO PAYMENT 1027588426841,06/14/2023,VENMO PAYMENT 1027588426841,,-400.0,,51580.77,,0.0,Personal
139,20230614000000[-6:CST]*-58.04*0**Alliant - IPL PAYMENT 3836938783,06/14/2023,Alliant - IPL PAYMENT 3836938783,,-58.04,,51980.77,,0.0,Bills & Utilities
140,20230613000000[-6:CST]*3.75*501**Interest paid,06/13/2023,Interest paid,,,3.75,52038.81,,0.0,Deposit
141,20230613000000[-6:CST]*-274.89*0**VERIZON WIRELESS PAYMENTS 05885909720000 1,06/13/2023,VERIZON WIRELESS PAYMENTS 05885909720000 1,,-274.89,,52035.06,,0.0,Bills & Utilities
142,20230613000000[-6:CST]*-55.42*0**XX3498 POS WITHDRAWAL. WAL-MART #0749 AM ES IA 24074901 159489,06/13/2023,XX3498 POS WITHDRAWAL. WAL-MART #0749 AM ES IA 24074901 159489,,-55.42,,52309.95,,0.0,Groceries
143,20230613000000[-6:CST]*-28.00*0**XX3498 POS WITHDRAWAL. HY VEE 1013 AMES IA 1 403689,06/13/2023,XX3498 POS WITHDRAWAL. HY VEE 1013 AMES IA 1 403689,,-28.0,,52365.37,,0.0,Groceries
144,20230612000000[-6:CST]*-120.00*0**XX3498 ATM WITHDRAWAL. 1314 ELATI ST. DE NVER CO ACFN5161 003647,06/12/2023,XX3498 ATM WITHDRAWAL. 1314 ELATI ST. DE NVER CO ACFN5161 003647,,-120.0,,52393.37,,0.0,Personal
145,20230612000000[-6:CST]*-3.50*0**ATM WITHDRAWAL FEE XX3498 ATM WITHDRAWAL . 1314 ELATI ST. DENVER CO ACFN5161 003,06/12/2023,ATM WITHDRAWAL FEE XX3498 ATM WITHDRAWAL . 1314 ELATI ST. DENVER CO ACFN5161 003,,-3.5,,52513.37,,0.0,Personal
146,20230609000000[-6:CST]*-32.18*0**XX3498 POS WITHDRAWAL. CITY-MARK 0260 B AVON CO 11042601 816405,06/09/2023,XX3498 POS WITHDRAWAL. CITY-MARK 0260 B AVON CO 11042601 816405,,-32.18,,52516.87,,0.0,Travel
147,20230609000000[-6:CST]*1760.75*501**THE HARTFORD 693 DPPASO 03129468,06/09/2023,THE HARTFORD 693 DPPASO 03129468,,,1760.75,52549.05,,0.0,Deposit
148,20230606000000[-6:CST]*-9240.29*0**CHASE CREDIT CRD AUTOPAY 000000000175339,06/06/2023,CHASE CREDIT CRD AUTOPAY 000000000175339,,-9240.29,,50788.3,,0.0,Bills & Utilities
149,20230606000000[-6:CST]*-20.42*0**XX3498 POS WITHDRAWAL. SAFEWAY #1293 CAM PBELL CA 23822754 902865,06/06/2023,XX3498 POS WITHDRAWAL. SAFEWAY #1293 CAM PBELL CA 23822754 902865,,-20.42,,60028.59,,0.0,Groceries
150,20230605000000[-6:CST]*-712.75*0**IBMC ACH PMTS XXXXXX2430,06/05/2023,IBMC ACH PMTS XXXXXX2430,,-712.75,,60049.01,,0.0,Home
151,20230602000000[-6:CST]*-50.00*0**VENMO PAYMENT 1027356615706,06/02/2023,VENMO PAYMENT 1027356615706,,-50.0,,60761.76,,0.0,Personal
152,20230602000000[-6:CST]*2200.94*501**THE HARTFORD 693 DPPASO 03129468,06/02/2023,THE HARTFORD 693 DPPASO 03129468,,,2200.94,60811.76,,0.0,Deposit
153,20230530000000[-6:CST]*-67.32*0**CITY OF AMES UT BILL 002629810006826,05/30/2023,CITY OF AMES UT BILL 002629810006826,,-67.32,,58610.82,,0.0,Bills & Utilities
154,20230526000000[-6:CST]*2200.92*501**THE HARTFORD 693 DPPASO 03129468,05/26/2023,THE HARTFORD 693 DPPASO 03129468,,,2200.92,58678.14,,0.0,Deposit
155,20230524000000[-6:CST]*-97.23*0**CITY OF AMES UT BILL 002819790003022,05/24/2023,CITY OF AMES UT BILL 002819790003022,,-97.23,,56477.22,,0.0,Bills & Utilities
156,20230523000000[-6:CST]*-589.88*0**FARMERS INS EFT PYMT mXXXXX5868,05/23/2023,FARMERS INS EFT PYMT mXXXXX5868,,-589.88,,56574.45,,0.0,Automotive
157,20230522000000[-6:CST]*-90.00*0**VENMO PAYMENT 1027132389031,05/22/2023,VENMO PAYMENT 1027132389031,,-90.0,,57164.33,,0.0,Personal
158,20230519000000[-6:CST]*-64.57*0**Alliant - IPL PAYMENT 0061467186,05/19/2023,Alliant - IPL PAYMENT 0061467186,,-64.57,,57254.33,,0.0,Bills & Utilities
159,20230519000000[-6:CST]*2200.94*501**THE HARTFORD 693 DPPASO 03129468,05/19/2023,THE HARTFORD 693 DPPASO 03129468,,,2200.94,57318.9,,0.0,Deposit
160,20230517000000[-6:CST]*-24.60*0**CLUB FEES PLANET FIT 515-450-5351,05/17/2023,CLUB FEES PLANET FIT 515-450-5351,,-24.6,,55117.96,,0.0,Personal
161,20230515000000[-6:CST]*-274.89*0**VERIZON WIRELESS PAYMENTS 05885909720000 1,05/15/2023,VERIZON WIRELESS PAYMENTS 05885909720000 1,,-274.89,,55142.56,,0.0,Bills & Utilities
162,20230512000000[-6:CST]*-85.26*0**Alliant - IPL PAYMENT 3836938783,05/12/2023,Alliant - IPL PAYMENT 3836938783,,-85.26,,55417.45,,0.0,Bills & Utilities
163,20230512000000[-6:CST]*3737.47*501**DONNELLEY FINANC DIRECT DEP 927328248258 L5Z,05/12/2023,DONNELLEY FINANC DIRECT DEP 927328248258 L5Z,,,3737.47,55502.71,,0.0,Deposit
164,20230511000000[-6:CST]*-40.00*0**VENMO PAYMENT 1026931362280,05/11/2023,VENMO PAYMENT 1026931362280,,-40.0,,51765.24,,0.0,Personal
165,20230509000000[-6:CST]*2.98*501**Interest paid,05/09/2023,Interest paid,,,2.98,51805.24,,0.0,Deposit
166,20230508000000[-6:CST]*-2394.48*0**CHASE CREDIT CRD AUTOPAY 000000000326074,05/08/2023,CHASE CREDIT CRD AUTOPAY 000000000326074,,-2394.48,,51802.26,,0.0,Bills & Utilities
167,20230508000000[-6:CST]*-24.00*0**XX3498 POS PURCHASE AT HAMPTON INNS RENO NV 59718910 822888,05/08/2023,XX3498 POS PURCHASE AT HAMPTON INNS RENO NV 59718910 822888,,-24.0,,54196.74,,0.0,Travel
168,20230505000000[-6:CST]*-712.75*0**IBMC ACH PMTS XXXXXX2430,05/05/2023,IBMC ACH PMTS XXXXXX2430,,-712.75,,54220.74,,0.0,Home
169,20230505000000[-6:CST]*-11.08*0**XX3498 POS WITHDRAWAL. CHEVRON/CSI-0989 GREENBRAE CA 10040101 628030,05/05/2023,XX3498 POS WITHDRAWAL. CHEVRON/CSI-0989 GREENBRAE CA 10040101 628030,,-11.08,,54933.49,,0.0,Travel
170,20230504000000[-6:CST]*-7.55*0**XX3498 POS PURCHASE AT PHOENIX CONOCO KI MBALL NE 41825571 839626,05/04/2023,XX3498 POS PURCHASE AT PHOENIX CONOCO KI MBALL NE 41825571 839626,,-7.55,,54944.57,,0.0,Food & Drink
171,20230503000000[-6:CST]*-26.00*0**RENT ON SAFE DEPOSIT BOX 10000703,05/03/2023,RENT ON SAFE DEPOSIT BOX 10000703,,-26.0,,54952.12,,0.0,Personal
172,20230503000000[-6:CST]*-25.00*0**XX3498 POS PURCHASE AT SQ *ACPS Ames IA 56421198 564964,05/03/2023,XX3498 POS PURCHASE AT SQ *ACPS Ames IA 56421198 564964,,-25.0,,54978.12,,0.0,Entertainment
173,20230503000000[-6:CST]*-4.49*0**XX3498 POS WITHDRAWAL. CASEYS #2734 COZA D NE 600001 016773,05/03/2023,XX3498 POS WITHDRAWAL. CASEYS #2734 COZA D NE 600001 016773,,-4.49,,55003.12,,0.0,Gas
174,20230502000000[-6:CST]*-200.00*0**VENMO PAYMENT 1026753085435,05/02/2023,VENMO PAYMENT 1026753085435,,-200.0,,55007.61,,0.0,Personal
175,20230502000000[-6:CST]*-15.97*0**XX3498 POS WITHDRAWAL. GATEWAYEXPRESS AM ES IA 0004L710 043994,05/02/2023,XX3498 POS WITHDRAWAL. GATEWAYEXPRESS AM ES IA 0004L710 043994,,-15.97,,55207.61,,0.0,Automotive
176,20230501000000[-6:CST]*-96.42*0**XX3498 POS WITHDRAWAL. TARGET T-1170 Ame s IA 600001 026253,05/01/2023,XX3498 POS WITHDRAWAL. TARGET T-1170 Ame s IA 600001 026253,,-96.42,,55223.58,,0.0,Shopping
177,20230501000000[-6:CST]*-45.14*0**XX3498 POS WITHDRAWAL. WAL-MART #0749 AM ES IA 24074901 462374,05/01/2023,XX3498 POS WITHDRAWAL. WAL-MART #0749 AM ES IA 24074901 462374,,-45.14,,55320.0,,0.0,Groceries
178,20230501000000[-6:CST]*-40.72*0**XX3498 POS WITHDRAWAL. Wal-Mart Super C AMES IA 07490043 311902352344,05/01/2023,XX3498 POS WITHDRAWAL. Wal-Mart Super C AMES IA 07490043 311902352344,,-40.72,,55365.14,,0.0,Groceries
179,20230501000000[-6:CST]*-20.00*0**XX3498 POS WITHDRAWAL. HY VEE CLINIC 30 AMES IA 1 344311,05/01/2023,XX3498 POS WITHDRAWAL. HY VEE CLINIC 30 AMES IA 1 344311,,-20.0,,55405.86,,0.0,Groceries
180,20230501000000[-6:CST]*-10.37*0**XX3498 POS PURCHASE AT B BOPS AMES NORT AMES IA 36420887 689322,05/01/2023,XX3498 POS PURCHASE AT B BOPS AMES NORT AMES IA 36420887 689322,,-10.37,,55425.86,,0.0,Food & Drink
181,20230501000000[-6:CST]*-8.09*0**XX3498 POS PURCHASE AT JAVA JOES COFFEE ANKENY IA 09131085 304170,05/01/2023,XX3498 POS PURCHASE AT JAVA JOES COFFEE ANKENY IA 09131085 304170,,-8.09,,55436.23,,0.0,Food & Drink
182,20230501000000[-6:CST]*-6.81*0**XX3498 POS PURCHASE AT TST* BURGIE'S CO AMES IA 27015725 084910,05/01/2023,XX3498 POS PURCHASE AT TST* BURGIE'S CO AMES IA 27015725 084910,,-6.81,,55444.32,,0.0,Food & Drink
183,20230501000000[-6:CST]*-280.00*0**Miscellaneous Debit,05/01/2023,Miscellaneous Debit,,-280.0,,55451.13,,0.0,Personal
184,20230501000000[-6:CST]*461.00*501**IASTTAXRFD IASTTAXRFD 000000000000000,05/01/2023,IASTTAXRFD IASTTAXRFD 000000000000000,,,461.0,55731.13,,0.0,Deposit
185,20230428000000[-6:CST]*-50.00*0**VENMO PAYMENT 1026669331613,04/28/2023,VENMO PAYMENT 1026669331613,,-50.0,,55270.13,,0.0,Personal
186,20230428000000[-6:CST]*-23.97*0**XX3498 POS PURCHASE AT RIEMAN MUSIC INC AMES IA 60669567 488934,04/28/2023,XX3498 POS PURCHASE AT RIEMAN MUSIC INC AMES IA 60669567 488934,,-23.97,,55320.13,,0.0,Personal
187,20230428000000[-6:CST]*-10.37*0**XX3498 POS PURCHASE AT CULVERS OF AMES A MES IA 00562118 410977,04/28/2023,XX3498 POS PURCHASE AT CULVERS OF AMES A MES IA 00562118 410977,,-10.37,,55344.1,,0.0,Food & Drink
188,20230428000000[-6:CST]*3737.46*501**DONNELLEY FINANC DIRECT DEP 930728040953 L5Z,04/28/2023,DONNELLEY FINANC DIRECT DEP 930728040953 L5Z,,,3737.46,55354.47,,0.0,Deposit
189,20230427000000[-6:CST]*-802.00*0**DHS CSRU IOW DHS IOWDHS012736620,04/27/2023,DHS CSRU IOW DHS IOWDHS012736620,,-802.0,,51617.01,,0.0,Bills & Utilities
190,20230427000000[-6:CST]*-80.06*0**CITY OF AMES UT BILL 002629810006826,04/27/2023,CITY OF AMES UT BILL 002629810006826,,-80.06,,52419.01,,0.0,Bills & Utilities
191,20230427000000[-6:CST]*-0.29*0**DHS CSRU conv fee IOWDHS012736621,04/27/2023,DHS CSRU conv fee IOWDHS012736621,,-0.29,,52499.07,,0.0,Bills & Utilities
192,20230427000000[-6:CST]*-61.00*0**XX3498 POS PURCHASE AT SQ *THE ANGRY IR AMES IA 23650767 178535,04/27/2023,XX3498 POS PURCHASE AT SQ *THE ANGRY IR AMES IA 23650767 178535,,-61.0,,52499.36,,0.0,Food & Drink
193,20230426000000[-6:CST]*-4280.00*1*1044*Check,04/26/2023,Check,,-4280.0,,52560.36,1044.0,0.0,Personal
194,20230426000000[-6:CST]*-62.68*0**XX3498 POS WITHDRAWAL. WAL-MART #0749 AM ES IA 24074901 813018,04/26/2023,XX3498 POS WITHDRAWAL. WAL-MART #0749 AM ES IA 24074901 813018,,-62.68,,56840.36,,0.0,Groceries
195,20230426000000[-6:CST]*-26.34*0**XX3498 POS PURCHASE AT JERSEY MIKES 380 AMES IA 03000286 587086,04/26/2023,XX3498 POS PURCHASE AT JERSEY MIKES 380 AMES IA 03000286 587086,,-26.34,,56903.04,,0.0,Food & Drink
196,20230426000000[-6:CST]*-25.00*0**XX3498 POS PURCHASE AT SQ *ACPS Ames IA 14330451 383856,04/26/2023,XX3498 POS PURCHASE AT SQ *ACPS Ames IA 14330451 383856,,-25.0,,56929.38,,0.0,Entertainment
197,20230426000000[-6:CST]*-15.00*0**XX3498 POS PURCHASE AT GOODWILL AMES AME S IA 99700082 761619,04/26/2023,XX3498 POS PURCHASE AT GOODWILL AMES AME S IA 99700082 761619,,-15.0,,56954.38,,0.0,Home
198,20230425000000[-6:CST]*-187.00*0**XX3498 POS WITHDRAWAL. WHEATSFIELD COOP AMES IA 68087201 658657,04/25/2023,XX3498 POS WITHDRAWAL. WHEATSFIELD COOP AMES IA 68087201 658657,,-187.0,,56969.38,,0.0,Groceries
199,20230425000000[-6:CST]*-51.04*0**XX3498 POS PURCHASE AT PERFECT GAMES AME S IA 72193258 324893,04/25/2023,XX3498 POS PURCHASE AT PERFECT GAMES AME S IA 72193258 324893,,-51.04,,57156.38,,0.0,Entertainment
200,20230424000000[-6:CST]*-585.50*0**FARMERS INS EFT PYMT mXXXXX5868,04/24/2023,FARMERS INS EFT PYMT mXXXXX5868,,-585.5,,57207.42,,0.0,Automotive
201,20230424000000[-6:CST]*-101.11*0**CITY OF AMES UT BILL 002819790003022,04/24/2023,CITY OF AMES UT BILL 002819790003022,,-101.11,,57792.92,,0.0,Bills & Utilities
202,20230424000000[-6:CST]*-38.60*0**XX3498 POS WITHDRAWAL. WALGREENS 2719 G AMES IA 12108T22 308816,04/24/2023,XX3498 POS WITHDRAWAL. WALGREENS 2719 G AMES IA 12108T22 308816,,-38.6,,57894.03,,0.0,Groceries
203,20230424000000[-6:CST]*-36.87*0**XX3498 POS PURCHASE AT LA CASA MAYA AMES IA 02604498 598894,04/24/2023,XX3498 POS PURCHASE AT LA CASA MAYA AMES IA 02604498 598894,,-36.87,,57932.63,,0.0,Food & Drink
204,20230421000000[-6:CST]*-1572.25*0**COUNTY TREASURER TAX 4033632,04/21/2023,COUNTY TREASURER TAX 4033632,,-1572.25,,57969.5,,0.0,Home
205,20230421000000[-6:CST]*-149.64*0**Alliant - IPL PAYMENT 0061467186,04/21/2023,Alliant - IPL PAYMENT 0061467186,,-149.64,,59541.75,,0.0,Bills & Utilities
206,20230421000000[-6:CST]*-59.98*0**XX3498 POS WITHDRAWAL. WAL-MART #0749 AM ES IA 24074901 969397,04/21/2023,XX3498 POS WITHDRAWAL. WAL-MART #0749 AM ES IA 24074901 969397,,-59.98,,59691.39,,0.0,Groceries
207,20230421000000[-6:CST]*-22.82*0**XX3498 POS WITHDRAWAL. CASEYS #2905 AMES IA 600001 021126,04/21/2023,XX3498 POS WITHDRAWAL. CASEYS #2905 AMES IA 600001 021126,,-22.82,,59751.37,,0.0,Gas
208,20230421000000[-6:CST]*3000.00*501**PAYPAL TRANSFER 1026533758599,04/21/2023,PAYPAL TRANSFER 1026533758599,,,3000.0,59774.19,,0.0,Deposit
209,20230420000000[-6:CST]*-200.00*0**XX3498 ATM WITHDRAWAL. 3334 LINCOLN WAY AMES IA IA000622 008406,04/20/2023,XX3498 ATM WITHDRAWAL. 3334 LINCOLN WAY AMES IA IA000622 008406,,-200.0,,56774.19,,0.0,Personal
210,20230420000000[-6:CST]*-32.96*0**XX3498 POS PURCHASE AT KWIK STOP LIQUOR AMES IA 93788670 036173,04/20/2023,XX3498 POS PURCHASE AT KWIK STOP LIQUOR AMES IA 93788670 036173,,-32.96,,56974.19,,0.0,Food & Drink
211,20230420000000[-6:CST]*-8.44*0**XX3498 POS WITHDRAWAL. MCDONALD'S M2021 AMES IA 81545307 842748,04/20/2023,XX3498 POS WITHDRAWAL. MCDONALD'S M2021 AMES IA 81545307 842748,,-8.44,,57007.15,,0.0,Food & Drink
212,20230420000000[-6:CST]*-8.12*0**XX3498 POS PURCHASE AT CULVERS OF AMES A MES IA 00550582 275080,04/20/2023,XX3498 POS PURCHASE AT CULVERS OF AMES A MES IA 00550582 275080,,-8.12,,57015.59,,0.0,Food & Drink
213,20230419000000[-6:CST]*-54.00*0**XX3498 POS PURCHASE AT O DONNELL ACE HA AMES IA 70002609 265177,04/19/2023,XX3498 POS PURCHASE AT O DONNELL ACE HA AMES IA 70002609 265177,,-54.0,,57023.71,,0.0,Home
214,20230419000000[-6:CST]*-28.00*0**XX3498 POS PURCHASE AT GOODWILL AMES AME S IA 99700107 969416,04/19/2023,XX3498 POS PURCHASE AT GOODWILL AMES AME S IA 99700107 969416,,-28.0,,57077.71,,0.0,Home
215,20230419000000[-6:CST]*-25.00*0**XX3498 POS PURCHASE AT SQ *ACPS Ames IA 76007165 771846,04/19/2023,XX3498 POS PURCHASE AT SQ *ACPS Ames IA 76007165 771846,,-25.0,,57105.71,,0.0,Entertainment
216,20230417000000[-6:CST]*-50.00*0**VENMO PAYMENT 1026463206546,04/17/2023,VENMO PAYMENT 1026463206546,,-50.0,,57130.71,,0.0,Personal
217,20230417000000[-6:CST]*-24.60*0**CLUB FEES PLANET FIT 515-450-5351,04/17/2023,CLUB FEES PLANET FIT 515-450-5351,,-24.6,,57180.71,,0.0,Personal
218,20230417000000[-6:CST]*-41.12*0**XX3498 POS WITHDRAWAL. Wal-Mart Super C AMES IA 07490049 310605542024,04/17/2023,XX3498 POS WITHDRAWAL. Wal-Mart Super C AMES IA 07490049 310605542024,,-41.12,,57205.31,,0.0,Groceries
219,20230417000000[-6:CST]*4.28*501**XX3498 POS RETURN..... O DONNELL ACE HA AMES IA 70002757 834181,04/17/2023,XX3498 POS RETURN..... O DONNELL ACE HA AMES IA 70002757 834181,,,4.28,57246.43,,0.0,Home
220,20230414000000[-6:CST]*-189.33*0**Alliant - IPL PAYMENT 3836938783,04/14/2023,Alliant - IPL PAYMENT 3836938783,,-189.33,,57242.15,,0.0,Bills & Utilities
221,20230414000000[-6:CST]*-200.00*0**XX3498 ATM WITHDRAWAL. 2406 GRAND AVE AM ES IA IA000624 006539,04/14/2023,XX3498 ATM WITHDRAWAL. 2406 GRAND AVE AM ES IA IA000624 006539,,-200.0,,57431.48,,0.0,Personal
222,20230414000000[-6:CST]*-96.00*0**XX3498 POS WITHDRAWAL. WAL-MART #749 AME S IA 600001 033770,04/14/2023,XX3498 POS WITHDRAWAL. WAL-MART #749 AME S IA 600001 033770,,-96.0,,57631.48,,0.0,Groceries
223,20230414000000[-6:CST]*-20.53*0**XX3498 POS PURCHASE AT SQ *1+1 RESTAURA AMES IA 50427462 864297,04/14/2023,XX3498 POS PURCHASE AT SQ *1+1 RESTAURA AMES IA 50427462 864297,,-20.53,,57727.48,,0.0,Food & Drink
224,20230414000000[-6:CST]*3737.46*501**DONNELLEY FINANC DIRECT DEP 785088944249 L5Z,04/14/2023,DONNELLEY FINANC DIRECT DEP 785088944249 L5Z,,,3737.46,57748.01,,0.0,Deposit
225,20230413000000[-6:CST]*-275.30*0**VERIZON WIRELESS PAYMENTS 05885909720000 1,04/13/2023,VERIZON WIRELESS PAYMENTS 05885909720000 1,,-275.3,,54010.55,,0.0,Bills & Utilities
226,20230412000000[-6:CST]*-105.00*0**XX3498 POS PURCHASE AT SQ *ACPS Ames IA 15965044 662238,04/12/2023,XX3498 POS PURCHASE AT SQ *ACPS Ames IA 15965044 662238,,-105.0,,54285.85,,0.0,Entertainment
227,20230411000000[-6:CST]*2.89*501**Interest paid,04/11/2023,Interest paid,,,2.89,54390.85,,0.0,Deposit
228,20230411000000[-6:CST]*-400.00*0**VENMO PAYMENT 1026339072481,04/11/2023,VENMO PAYMENT 1026339072481,,-400.0,,54387.96,,0.0,Personal
229,20230411000000[-6:CST]*-150.00*0**VENMO PAYMENT 1026339480482,04/11/2023,VENMO PAYMENT 1026339480482,,-150.0,,54787.96,,0.0,Personal
230,20230411000000[-6:CST]*-77.55*0**ASPEN WASTE SYST EFT PMT 8 00257691,04/11/2023,ASPEN WASTE SYST EFT PMT 8 00257691,,-77.55,,54937.96,,0.0,Bills & Utilities
231,20230411000000[-6:CST]*-20.00*0**VENMO PAYMENT 1026339080099,04/11/2023,VENMO PAYMENT 1026339080099,,-20.0,,55015.51,,0.0,Personal
232,20230411000000[-6:CST]*-57.00*0**XX3498 POS WITHDRAWAL. HY VEE 1013 AMES IA 1 839145,04/11/2023,XX3498 POS WITHDRAWAL. HY VEE 1013 AMES IA 1 839145,,-57.0,,55035.51,,0.0,Groceries
233,20230411000000[-6:CST]*-30.37*0**XX3498 POS PURCHASE AT CAFEBEAUDELAIRE A MES IA 18200098 034213,04/11/2023,XX3498 POS PURCHASE AT CAFEBEAUDELAIRE A MES IA 18200098 034213,,-30.37,,55092.51,,0.0,Food & Drink
234,20230410000000[-6:CST]*-127.12*0**XX3498 POS WITHDRAWAL. ALDI 72048 AMES I A 88741003 542299,04/10/2023,XX3498 POS WITHDRAWAL. ALDI 72048 AMES I A 88741003 542299,,-127.12,,55122.88,,0.0,Groceries
235,20230410000000[-6:CST]*-20.05*0**XX3498 POS PURCHASE AT ABERLARDOSMEXICA AMES IA 11562953 356992,04/10/2023,XX3498 POS PURCHASE AT ABERLARDOSMEXICA AMES IA 11562953 356992,,-20.05,,55250.0,,0.0,Food & Drink
236,20230410000000[-6:CST]*-20.00*0**XX3498 POS WITHDRAWAL. HY VEE CLINIC 30 AMES IA 1 758856,04/10/2023,XX3498 POS WITHDRAWAL. HY VEE CLINIC 30 AMES IA 1 758856,,-20.0,,55270.05,,0.0,Groceries
237,20230410000000[-6:CST]*-16.00*0**XX3498 POS PURCHASE AT O DONNELL ACE HA AMES IA 70001444 765866,04/10/2023,XX3498 POS PURCHASE AT O DONNELL ACE HA AMES IA 70001444 765866,,-16.0,,55290.05,,0.0,Home
238,20230407000000[-6:CST]*-200.00*0**XX3498 ATM WITHDRAWAL. 2406 GRAND AVE AM ES IA IA000624 006128,04/07/2023,XX3498 ATM WITHDRAWAL. 2406 GRAND AVE AM ES IA IA000624 006128,,-200.0,,55306.05,,0.0,Personal
239,20230407000000[-6:CST]*-60.00*0**XX3498 POS PURCHASE AT SQ *THE ANGRY IR Ames IA 70194310 120914,04/07/2023,XX3498 POS PURCHASE AT SQ *THE ANGRY IR Ames IA 70194310 120914,,-60.0,,55506.05,,0.0,Food & Drink
240,20230407000000[-6:CST]*-9.08*0**XX3498 POS PURCHASE AT ARBY S 5537 AMES IA 92527596 510802,04/07/2023,XX3498 POS PURCHASE AT ARBY S 5537 AMES IA 92527596 510802,,-9.08,,55566.05,,0.0,Food & Drink
241,20230407000000[-6:CST]*1197.00*501**IRS TREAS 310 TAX REF XXXXXXXXXXX0918,04/07/2023,IRS TREAS 310 TAX REF XXXXXXXXXXX0918,,,1197.0,55575.13,,0.0,Deposit
242,20230406000000[-6:CST]*-896.85*0**CHASE CREDIT CRD AUTOPAY 000000000172384,04/06/2023,CHASE CREDIT CRD AUTOPAY 000000000172384,,-896.85,,54378.13,,0.0,Bills & Utilities
243,20230405000000[-6:CST]*-712.75*0**IBMC ACH PMTS XXXXXX2430,04/05/2023,IBMC ACH PMTS XXXXXX2430,,-712.75,,55274.98,,0.0,Home
244,20230405000000[-6:CST]*-87.00*0**XX3498 POS WITHDRAWAL. WHEATSFIELD COOP AMES IA 68087201 078866,04/05/2023,XX3498 POS WITHDRAWAL. WHEATSFIELD COOP AMES IA 68087201 078866,,-87.0,,55987.73,,0.0,Groceries
245,20230405000000[-6:CST]*-25.00*0**XX3498 POS PURCHASE AT SQ *ACPS Ames IA 53385058 038938,04/05/2023,XX3498 POS PURCHASE AT SQ *ACPS Ames IA 53385058 038938,,-25.0,,56074.73,,0.0,Entertainment
246,20230405000000[-6:CST]*-13.13*0**XX3498 POS PURCHASE AT TACO BELL #30421 AMES IA 02156536 175933,04/05/2023,XX3498 POS PURCHASE AT TACO BELL #30421 AMES IA 02156536 175933,,-13.13,,56099.73,,0.0,Food & Drink
247,20230404000000[-6:CST]*-8.01*0**XX3498 POS WITHDRAWAL. MCDONALD'S M2021 AMES IA 81545314 550486,04/04/2023,XX3498 POS WITHDRAWAL. MCDONALD'S M2021 AMES IA 81545314 550486,,-8.01,,56112.86,,0.0,Food & Drink
248,20230404000000[-6:CST]*-150.00*0**00201721 TRANSFER TO 780750 ON 4/04/23 A T 12:02,04/04/2023,00201721 TRANSFER TO 780750 ON 4/04/23 A T 12:02,,-150.0,,56120.87,,0.0,Personal
249,20230403000000[-6:CST]*-57.35*0**XX3498 POS WITHDRAWAL. HY VEE 1013 AMES IA 1 062790,04/03/2023,XX3498 POS WITHDRAWAL. HY VEE 1013 AMES IA 1 062790,,-57.35,,56270.87,,0.0,Groceries
250,20230403000000[-6:CST]*-41.09*0**XX3498 POS PURCHASE AT SQ *MAYGEE INC Am es IA 78425077 181756,04/03/2023,XX3498 POS PURCHASE AT SQ *MAYGEE INC Am es IA 78425077 181756,,-41.09,,56328.22,,0.0,Food & Drink
251,20230403000000[-6:CST]*-27.02*0**XX3498 POS WITHDRAWAL. WALGREENS 2719 G AMES IA 12108T22 356527,04/03/2023,XX3498 POS WITHDRAWAL. WALGREENS 2719 G AMES IA 12108T22 356527,,-27.02,,56369.31,,0.0,Groceries
252,20230403000000[-6:CST]*-26.61*0**XX3498 POS PURCHASE AT SQ *CORNBRED BAR Ames IA 25154884 845877,04/03/2023,XX3498 POS PURCHASE AT SQ *CORNBRED BAR Ames IA 25154884 845877,,-26.61,,56396.33,,0.0,Food & Drink
253,20230403000000[-6:CST]*-20.00*0**XX3498 POS PURCHASE AT HABITAT FOR HUMA AMES IA 17938765 236917,04/03/2023,XX3498 POS PURCHASE AT HABITAT FOR HUMA AMES IA 17938765 236917,,-20.0,,56422.94,,0.0,Home
254,20230403000000[-6:CST]*1290.72*501**XX3498 CHECK DEPOSIT.. 405 5TH ST AMES I A IA000619 005765,04/03/2023,XX3498 CHECK DEPOSIT.. 405 5TH ST AMES I A IA000619 005765,,,1290.72,56442.94,,0.0,Deposit
255,20230331000000[-6:CST]*-200.00*0**XX3498 ATM WITHDRAWAL. 405 5TH ST AMES I A IA000614 009033,03/31/2023,XX3498 ATM WITHDRAWAL. 405 5TH ST AMES I A IA000614 009033,,-200.0,,55152.22,,0.0,Personal
256,20230331000000[-6:CST]*3737.47*501**DONNELLEY FINANC DIRECT DEP 942224502345 L5Z,03/31/2023,DONNELLEY FINANC DIRECT DEP 942224502345 L5Z,,,3737.47,55352.22,,0.0,Deposit
257,20230330000000[-6:CST]*-45.00*0**XX3498 POS PURCHASE AT SQ *THE ANGRY IR Ames IA 77635965 317182,03/30/2023,XX3498 POS PURCHASE AT SQ *THE ANGRY IR Ames IA 77635965 317182,,-45.0,,51614.75,,0.0,Food & Drink
258,20230328000000[-6:CST]*-132.00*0**XX3498 POS WITHDRAWAL. WHEATSFIELD COOP AMES IA 68087201 586257,03/28/2023,XX3498 POS WITHDRAWAL. WHEATSFIELD COOP AMES IA 68087201 586257,,-132.0,,51659.75,,0.0,Groceries
259,20230328000000[-6:CST]*-74.20*0**XX3498 POS PURCHASE AT PERFECT GAMES AME S IA 68021707 860495,03/28/2023,XX3498 POS PURCHASE AT PERFECT GAMES AME S IA 68021707 860495,,-74.2,,51791.75,,0.0,Entertainment
260,20230328000000[-6:CST]*-55.72*0**XX3498 POS WITHDRAWAL. HY VEE 1013 AMES IA 1 674327,03/28/2023,XX3498 POS WITHDRAWAL. HY VEE 1013 AMES IA 1 674327,,-55.72,,51865.95,,0.0,Groceries
261,20230328000000[-6:CST]*-42.13*0**XX3498 POS WITHDRAWAL. Wal-Mart Super C AMES IA 07490045 308703952515,03/28/2023,XX3498 POS WITHDRAWAL. Wal-Mart Super C AMES IA 07490045 308703952515,,-42.13,,51921.67,,0.0,Groceries
262,20230327000000[-6:CST]*-802.00*0**DHS CSRU IOW DHS IOWDHS012606363,03/27/2023,DHS CSRU IOW DHS IOWDHS012606363,,-802.0,,51963.8,,0.0,Bills & Utilities
263,20230327000000[-6:CST]*-80.57*0**CITY OF AMES UT BILL 002629810006826,03/27/2023,CITY OF AMES UT BILL 002629810006826,,-80.57,,52765.8,,0.0,Bills & Utilities
264,20230327000000[-6:CST]*-0.29*0**DHS CSRU conv fee IOWDHS012606364,03/27/2023,DHS CSRU conv fee IOWDHS012606364,,-0.29,,52846.37,,0.0,Bills & Utilities
265,20230327000000[-6:CST]*-45.00*0**XX3498 POS WITHDRAWAL. HY VEE 1018 AMES IA 1 301948,03/27/2023,XX3498 POS WITHDRAWAL. HY VEE 1018 AMES IA 1 301948,,-45.0,,52846.66,,0.0,Groceries
266,20230327000000[-6:CST]*-22.41*0**XX3498 POS PURCHASE AT KWIK STOP LIQUOR AMES IA 49734021 317922,03/27/2023,XX3498 POS PURCHASE AT KWIK STOP LIQUOR AMES IA 49734021 317922,,-22.41,,52891.66,,0.0,Food & Drink
267,20230327000000[-6:CST]*-9.41*0**XX3498 POS WITHDRAWAL. MCDONALD'S M2021 AMES IA 81545307 515229,03/27/2023,XX3498 POS WITHDRAWAL. MCDONALD'S M2021 AMES IA 81545307 515229,,-9.41,,52914.07,,0.0,Food & Drink
268,20230327000000[-6:CST]*-9.19*0**XX3498 POS PURCHASE AT B BOPS AMES NORT AMES IA 22730408 016295,03/27/2023,XX3498 POS PURCHASE AT B BOPS AMES NORT AMES IA 22730408 016295,,-9.19,,52923.48,,0.0,Food & Drink
269,20230323000000[-6:CST]*-585.52*0**FARMERS INS EFT PYMT mXXXXX5868,03/23/2023,FARMERS INS EFT PYMT mXXXXX5868,,-585.52,,52932.67,,0.0,Automotive
270,20230323000000[-6:CST]*-110.27*0**CITY OF AMES UT BILL 002819790003022,03/23/2023,CITY OF AMES UT BILL 002819790003022,,-110.27,,53518.19,,0.0,Bills & Utilities
271,20230323000000[-6:CST]*-200.00*0**XX3498 ATM WITHDRAWAL. 2406 GRAND AVE AM ES IA IA000624 005362,03/23/2023,XX3498 ATM WITHDRAWAL. 2406 GRAND AVE AM ES IA IA000624 005362,,-200.0,,53628.46,,0.0,Personal
272,20230323000000[-6:CST]*-61.00*0**XX3498 POS PURCHASE AT O DONNELL ACE HA AMES IA 75001926 290056,03/23/2023,XX3498 POS PURCHASE AT O DONNELL ACE HA AMES IA 75001926 290056,,-61.0,,53828.46,,0.0,Home
273,20230322000000[-6:CST]*-201.43*0**Alliant - IPL PAYMENT 0061467186,03/22/2023,Alliant - IPL PAYMENT 0061467186,,-201.43,,53889.46,,0.0,Bills & Utilities
274,20230322000000[-6:CST]*-28.00*0**XX3498 POS PURCHASE AT GOODWILL AMES AME S IA 99700109 534964,03/22/2023,XX3498 POS PURCHASE AT GOODWILL AMES AME S IA 99700109 534964,,-28.0,,54090.89,,0.0,Home
275,20230322000000[-6:CST]*-25.00*0**XX3498 POS PURCHASE AT SQ *ACPS Ames IA 13387843 434796,03/22/2023,XX3498 POS PURCHASE AT SQ *ACPS Ames IA 13387843 434796,,-25.0,,54118.89,,0.0,Entertainment
276,20230321000000[-6:CST]*-30.00*0**VENMO PAYMENT 1025936398580,03/21/2023,VENMO PAYMENT 1025936398580,,-30.0,,54143.89,,0.0,Personal
277,20230321000000[-6:CST]*-78.08*0**XX3498 POS WITHDRAWAL. WAL-MART #749 AME S IA 600001 039095,03/21/2023,XX3498 POS WITHDRAWAL. WAL-MART #749 AME S IA 600001 039095,,-78.08,,54173.89,,0.0,Groceries
278,20230321000000[-6:CST]*-22.00*0**XX3498 POS WITHDRAWAL. WHEATSFIELD COOP AMES IA 68087201 265715,03/21/2023,XX3498 POS WITHDRAWAL. WHEATSFIELD COOP AMES IA 68087201 265715,,-22.0,,54251.97,,0.0,Groceries
279,20230321000000[-6:CST]*-13.52*0**XX3498 POS WITHDRAWAL. KUMGO 1215 AMES AMES IA 001 895941,03/21/2023,XX3498 POS WITHDRAWAL. KUM&GO 1215 AMES AMES IA 001 895941,,-13.52,,54273.97,,0.0,Gas
280,20230320000000[-6:CST]*-9.00*0**XX3498 POS PURCHASE AT SUPER SHINE AMES AMES IA 05932564 316504,03/20/2023,XX3498 POS PURCHASE AT SUPER SHINE AMES AMES IA 05932564 316504,,-9.0,,54287.49,,0.0,Automotive
281,20230317000000[-6:CST]*-24.60*0**CLUB FEES PLANET FIT 515-450-5351,03/17/2023,CLUB FEES PLANET FIT 515-450-5351,,-24.6,,54296.49,,0.0,Personal
282,20230317000000[-6:CST]*-49.86*0**XX3498 POS WITHDRAWAL. Wal-Mart Super C AMES IA 07490049 307677452427,03/17/2023,XX3498 POS WITHDRAWAL. Wal-Mart Super C AMES IA 07490049 307677452427,,-49.86,,54321.09,,0.0,Groceries
283,20230317000000[-6:CST]*-13.38*0**XX3498 POS PURCHASE AT SQ *LOCKWOOD AMES IA 25787678 797692,03/17/2023,XX3498 POS PURCHASE AT SQ *LOCKWOOD AMES IA 25787678 797692,,-13.38,,54370.95,,0.0,Food & Drink
284,20230317000000[-6:CST]*3737.46*501**DONNELLEY FINANC DIRECT DEP 445066695265 L5Z,03/17/2023,DONNELLEY FINANC DIRECT DEP 445066695265 L5Z,,,3737.46,54384.33,,0.0,Deposit
285,20230315000000[-6:CST]*-233.40*0**Alliant - IPL PAYMENT 3836938783,03/15/2023,Alliant - IPL PAYMENT 3836938783,,-233.4,,50646.87,,0.0,Bills & Utilities
286,20230315000000[-6:CST]*-100.00*0**VENMO PAYMENT 1025820875491,03/15/2023,VENMO PAYMENT 1025820875491,,-100.0,,50880.27,,0.0,Personal
287,20230315000000[-6:CST]*-34.75*0**XX3498 POS PURCHASE AT SQ *WOK N ROLL Am es IA 59305991 227508,03/15/2023,XX3498 POS PURCHASE AT SQ *WOK N ROLL Am es IA 59305991 227508,,-34.75,,50980.27,,0.0,Food & Drink
288,20230315000000[-6:CST]*-25.00*0**XX3498 POS PURCHASE AT SQ *ACPS Ames IA 12769028 865820,03/15/2023,XX3498 POS PURCHASE AT SQ *ACPS Ames IA 12769028 865820,,-25.0,,51015.02,,0.0,Entertainment
289,20230315000000[-6:CST]*9255.81*501**DONNELLEY FINANC DIRECT DEP 519087167086 L5Z,03/15/2023,DONNELLEY FINANC DIRECT DEP 519087167086 L5Z,,,9255.81,51040.02,,0.0,Deposit
290,20230314000000[-6:CST]*2.40*501**Interest paid,03/14/2023,Interest paid,,,2.4,41784.21,,0.0,Deposit
291,20230314000000[-6:CST]*-275.30*0**VERIZON WIRELESS PAYMENTS 05885909720000 1,03/14/2023,VERIZON WIRELESS PAYMENTS 05885909720000 1,,-275.3,,41781.81,,0.0,Bills & Utilities
292,20230314000000[-6:CST]*-133.00*0**XX3498 POS WITHDRAWAL. WHEATSFIELD COOP AMES IA 68087201 193902,03/14/2023,XX3498 POS WITHDRAWAL. WHEATSFIELD COOP AMES IA 68087201 193902,,-133.0,,42057.11,,0.0,Groceries
293,20230314000000[-6:CST]*-17.12*0**XX3498 POS PURCHASE AT PERFECT GAMES AME S IA 67805585 967972,03/14/2023,XX3498 POS PURCHASE AT PERFECT GAMES AME S IA 67805585 967972,,-17.12,,42190.11,,0.0,Entertainment
294,20230314000000[-6:CST]*-8.44*0**XX3498 POS WITHDRAWAL. MCDONALD'S M2021 AMES IA 81545307 281343,03/14/2023,XX3498 POS WITHDRAWAL. MCDONALD'S M2021 AMES IA 81545307 281343,,-8.44,,42207.23,,0.0,Food & Drink
295,20230313000000[-6:CST]*-100.00*0**XX3498 ATM WITHDRAWAL. 2406 GRAND AVE AM ES IA IA000624 004772,03/13/2023,XX3498 ATM WITHDRAWAL. 2406 GRAND AVE AM ES IA IA000624 004772,,-100.0,,42215.67,,0.0,Personal
296,20230313000000[-6:CST]*-400.00*0**00878415 TRANSFER TO 780750 ON 3/12/23 A T 16:07,03/13/2023,00878415 TRANSFER TO 780750 ON 3/12/23 A T 16:07,,-400.0,,42315.67,,0.0,Personal
297,20230310000000[-6:CST]*-100.00*0**XX3498 ATM WITHDRAWAL. 119 MAIN ST AMES IA RT35199 009646,03/10/2023,XX3498 ATM WITHDRAWAL. 119 MAIN ST AMES IA RT35199 009646,,-100.0,,42715.67,,0.0,Personal
298,20230310000000[-6:CST]*-46.00*0**XX3498 POS PURCHASE AT SQ *THE ANGRY IR Ames IA 12947490 717885,03/10/2023,XX3498 POS PURCHASE AT SQ *THE ANGRY IR Ames IA 12947490 717885,,-46.0,,42815.67,,0.0,Food & Drink
299,20230310000000[-6:CST]*-3.49*0**ATM WITHDRAWAL FEE XX3498 ATM WITHDRAWAL . 119 MAIN ST AMES IA RT35199 009646,03/10/2023,ATM WITHDRAWAL FEE XX3498 ATM WITHDRAWAL . 119 MAIN ST AMES IA RT35199 009646,,-3.49,,42861.67,,0.0,Personal
300,20230310000000[-6:CST]*307.80*501**DONNELLEY FINANC DIRECT-PAY 34735204,03/10/2023,DONNELLEY FINANC DIRECT-PAY 34735204,,,307.8,42865.16,,0.0,Deposit
301,20230310000000[-6:CST]*30.00*501**DONNELLEY FINANC DIRECT-PAY 34735221,03/10/2023,DONNELLEY FINANC DIRECT-PAY 34735221,,,30.0,42557.36,,0.0,Deposit
302,20230309000000[-6:CST]*-41.20*0**XX3498 POS WITHDRAWAL. HY VEE 1013 AMES IA 1 853487,03/09/2023,XX3498 POS WITHDRAWAL. HY VEE 1013 AMES IA 1 853487,,-41.2,,42527.36,,0.0,Groceries
303,20230308000000[-6:CST]*-80.18*0**XX3498 POS WITHDRAWAL. WAL-MART #0749 AM ES IA 24074901 239153,03/08/2023,XX3498 POS WITHDRAWAL. WAL-MART #0749 AM ES IA 24074901 239153,,-80.18,,42568.56,,0.0,Groceries
304,20230307000000[-6:CST]*-80.76*0**XX3498 POS PURCHASE AT PERFECT GAMES AME S IA 60640780 068266,03/07/2023,XX3498 POS PURCHASE AT PERFECT GAMES AME S IA 60640780 068266,,-80.76,,42648.74,,0.0,Entertainment
305,20230307000000[-6:CST]*-9.72*0**XX3498 POS WITHDRAWAL. MCDONALD'S M2021 AMES IA 81545316 074529,03/07/2023,XX3498 POS WITHDRAWAL. MCDONALD'S M2021 AMES IA 81545316 074529,,-9.72,,42729.5,,0.0,Food & Drink
306,20230306000000[-6:CST]*-4516.32*0**CHASE CREDIT CRD AUTOPAY 000000000175244,03/06/2023,CHASE CREDIT CRD AUTOPAY 000000000175244,,-4516.32,,42739.22,,0.0,Bills & Utilities
307,20230306000000[-6:CST]*-712.75*0**IOWA BANKERS MTG ACH PMT XXXXXX2430,03/06/2023,IOWA BANKERS MTG ACH PMT XXXXXX2430,,-712.75,,47255.54,,0.0,Home
308,20230306000000[-6:CST]*-200.00*0**XX3498 ATM WITHDRAWAL. 2406 GRAND AVE AM ES IA IA000624 004509,03/06/2023,XX3498 ATM WITHDRAWAL. 2406 GRAND AVE AM ES IA IA000624 004509,,-200.0,,47968.29,,0.0,Personal
309,20230306000000[-6:CST]*-62.00*0**XX3498 POS WITHDRAWAL. WHEATSFIELD COOP AMES IA 68087201 903484,03/06/2023,XX3498 POS WITHDRAWAL. WHEATSFIELD COOP AMES IA 68087201 903484,,-62.0,,48168.29,,0.0,Groceries
310,20230306000000[-6:CST]*-25.00*0**XX3498 POS PURCHASE AT SQ *ACPS Ames IA 38978413 619996,03/06/2023,XX3498 POS PURCHASE AT SQ *ACPS Ames IA 38978413 619996,,-25.0,,48230.29,,0.0,Entertainment
311,20230306000000[-6:CST]*-11.62*0**XX3498 POS PURCHASE AT KWIK STOP LIQUOR AMES IA 19443307 799757,03/06/2023,XX3498 POS PURCHASE AT KWIK STOP LIQUOR AMES IA 19443307 799757,,-11.62,,48255.29,,0.0,Food & Drink
312,20230303000000[-6:CST]*3737.46*501**DONNELLEY FINANC DIRECT DEP 714089570665 L5Z,03/03/2023,DONNELLEY FINANC DIRECT DEP 714089570665 L5Z,,,3737.46,48266.91,,0.0,Deposit
313,20230301000000[-6:CST]*-50.00*0**VENMO PAYMENT 1025549797284,03/01/2023,VENMO PAYMENT 1025549797284,,-50.0,,44529.45,,0.0,Personal
314,20230301000000[-6:CST]*-41.73*0**CLUB FEES PLANET FIT 515-620-8880,03/01/2023,CLUB FEES PLANET FIT 515-620-8880,,-41.73,,44579.45,,0.0,Personal
315,20230228000000[-6:CST]*-50.14*0**XX3498 POS WITHDRAWAL. HY VEE 1013 AMES IA 1 520599,02/28/2023,XX3498 POS WITHDRAWAL. HY VEE 1013 AMES IA 1 520599,,-50.14,,44621.18,,0.0,Groceries
316,20230227000000[-6:CST]*-200.00*0**XX3498 ATM WITHDRAWAL. 2406 GRAND AVE AM ES IA IA000624 004080,02/27/2023,XX3498 ATM WITHDRAWAL. 2406 GRAND AVE AM ES IA IA000624 004080,,-200.0,,44671.32,,0.0,Personal
317,20230227000000[-6:CST]*-121.53*0**XX3498 POS WITHDRAWAL. WAL-MART #749 AME S IA 600001 042656,02/27/2023,XX3498 POS WITHDRAWAL. WAL-MART #749 AME S IA 600001 042656,,-121.53,,44871.32,,0.0,Groceries
318,20230227000000[-6:CST]*-71.48*0**XX3498 POS PURCHASE AT SQ *MUCKY DUCK P Ames IA 47744865 239374,02/27/2023,XX3498 POS PURCHASE AT SQ *MUCKY DUCK P Ames IA 47744865 239374,,-71.48,,44992.85,,0.0,Food & Drink
319,20230227000000[-6:CST]*-42.10*0**XX3498 POS PURCHASE AT AUNT MAUDES AMES IA 10800295 032975,02/27/2023,XX3498 POS PURCHASE AT AUNT MAUDES AMES IA 10800295 032975,,-42.1,,45064.33,,0.0,Food & Drink
320,20230227000000[-6:CST]*-17.01*0**XX3498 POS PURCHASE AT SQ *flying Iowa City IA 55881745 805427,02/27/2023,XX3498 POS PURCHASE AT SQ *OASIS FALAFE Iowa City IA 55881745 805427,,-17.01,,45106.43,,0.0,Food & Drink
321,20230224000000[-6:CST]*-80.70*0**CITY OF AMES UT BILL 002629810006826,02/24/2023,CITY OF AMES UT BILL 002629810006826,,-80.7,,45123.44,,0.0,Bills & Utilities
322,20230223000000[-6:CST]*-588.14*0**FARMERS INS EFT PYMT mXXXXX5868,02/23/2023,FARMERS INS EFT PYMT mXXXXX5868,,-588.14,,45204.14,,0.0,Automotive
323,20230222000000[-6:CST]*-112.62*0**CITY OF AMES UT BILL 002819790003022,02/22/2023,CITY OF AMES UT BILL 002819790003022,,-112.62,,45792.28,,0.0,Bills & Utilities
324,20230222000000[-6:CST]*-25.00*0**XX3498 POS PURCHASE AT SQ *ACPS Ames IA 26563234 037258,02/22/2023,XX3498 POS PURCHASE AT SQ *ACPS Ames IA 26563234 037258,,-25.0,,45904.9,,0.0,Entertainment
325,20230221000000[-6:CST]*-183.32*0**Alliant - IPL PAYMENT 0061467186,02/21/2023,Alliant - IPL PAYMENT 0061467186,,-183.32,,45929.9,,0.0,Bills & Utilities
326,20230221000000[-6:CST]*-50.00*0**VENMO PAYMENT 1025343256887,02/21/2023,VENMO PAYMENT 1025343256887,,-50.0,,46113.22,,0.0,Personal
327,20230221000000[-6:CST]*-200.00*0**XX3498 ATM WITHDRAWAL. 3334 LINCOLN WAY AMES IA IA000622 007077,02/21/2023,XX3498 ATM WITHDRAWAL. 3334 LINCOLN WAY AMES IA IA000622 007077,,-200.0,,46163.22,,0.0,Personal
328,20230221000000[-6:CST]*-118.29*0**XX3498 POS PURCHASE AT PERFECT GAMES AME S IA 99698771 650686,02/21/2023,XX3498 POS PURCHASE AT PERFECT GAMES AME S IA 99698771 650686,,-118.29,,46363.22,,0.0,Entertainment
329,20230221000000[-6:CST]*-93.37*0**XX3498 POS WITHDRAWAL. Wal-Mart Super C AMES IA 07490048 304952000326,02/21/2023,XX3498 POS WITHDRAWAL. Wal-Mart Super C AMES IA 07490048 304952000326,,-93.37,,46481.51,,0.0,Groceries
330,20230221000000[-6:CST]*-80.54*0**XX3498 POS PURCHASE AT SQ *MUCKY DUCK P Ames IA 61513381 660829,02/21/2023,XX3498 POS PURCHASE AT SQ *MUCKY DUCK P Ames IA 61513381 660829,,-80.54,,46574.88,,0.0,Food & Drink
331,20230221000000[-6:CST]*-65.00*0**XX3498 POS PURCHASE AT GOODWILL AMES AME S IA 99701328 708347,02/21/2023,XX3498 POS PURCHASE AT GOODWILL AMES AME S IA 99701328 708347,,-65.0,,46655.42,,0.0,Home
332,20230221000000[-6:CST]*-64.00*0**XX3498 POS WITHDRAWAL. WHEATSFIELD COOP AMES IA 68087201 713043,02/21/2023,XX3498 POS WITHDRAWAL. WHEATSFIELD COOP AMES IA 68087201 713043,,-64.0,,46720.42,,0.0,Groceries
333,20230221000000[-6:CST]*-27.24*0**XX3498 POS WITHDRAWAL. HY VEE CLINIC 30 AMES IA 001 816987,02/21/2023,XX3498 POS WITHDRAWAL. HY VEE CLINIC 30 AMES IA 001 816987,,-27.24,,46784.42,,0.0,Groceries
334,20230221000000[-6:CST]*-8.56*0**XX3498 POS PURCHASE AT PERFECT GAMES AME S IA 99698938 538525,02/21/2023,XX3498 POS PURCHASE AT PERFECT GAMES AME S IA 99698938 538525,,-8.56,,46811.66,,0.0,Entertainment
335,20230221000000[-6:CST]*-8.56*0**XX3498 POS PURCHASE AT PERFECT GAMES AME S IA 99698854 146123,02/21/2023,XX3498 POS PURCHASE AT PERFECT GAMES AME S IA 99698854 146123,,-8.56,,46820.22,,0.0,Entertainment
336,20230221000000[-6:CST]*-8.44*0**XX3498 POS WITHDRAWAL. MCDONALD'S M2021 AMES IA 81545316 932042,02/21/2023,XX3498 POS WITHDRAWAL. MCDONALD'S M2021 AMES IA 81545316 932042,,-8.44,,46828.78,,0.0,Food & Drink
337,20230217000000[-6:CST]*-802.00*0**DHS CSRU IOW DHS IOWDHS012450003,02/17/2023,DHS CSRU IOW DHS IOWDHS012450003,,-802.0,,46837.22,,0.0,Bills & Utilities
338,20230217000000[-6:CST]*-24.60*0**CLUB FEES PLANET FIT 515-620-8880,02/17/2023,CLUB FEES PLANET FIT 515-620-8880,,-24.6,,47639.22,,0.0,Personal
339,20230217000000[-6:CST]*-0.29*0**DHS CSRU conv fee IOWDHS012450004,02/17/2023,DHS CSRU conv fee IOWDHS012450004,,-0.29,,47663.82,,0.0,Bills & Utilities
340,20230217000000[-6:CST]*-69.22*0**XX3498 POS PURCHASE AT SQ *CORNBRED BAR Ames IA 72055442 222441,02/17/2023,XX3498 POS PURCHASE AT SQ *CORNBRED BAR Ames IA 72055442 222441,,-69.22,,47664.11,,0.0,Food & Drink
341,20230217000000[-6:CST]*3737.47*501**DONNELLEY FINANC DIRECT DEP 930528050385 L5Z,02/17/2023,DONNELLEY FINANC DIRECT DEP 930528050385 L5Z,,,3737.47,47733.33,,0.0,Deposit
342,20230216000000[-6:CST]*-120.00*0**XX3498 ATM WITHDRAWAL. 119 MAIN ST AMES IA RT35199 009593,02/16/2023,XX3498 ATM WITHDRAWAL. 119 MAIN ST AMES IA RT35199 009593,,-120.0,,43995.86,,0.0,Personal
343,20230216000000[-6:CST]*-18.00*0**XX3498 POS PURCHASE AT SQ *OVERFLOW THR Ames IA 66660980 705395,02/16/2023,XX3498 POS PURCHASE AT SQ *OVERFLOW THR Ames IA 66660980 705395,,-18.0,,44115.86,,0.0,Food & Drink
344,20230216000000[-6:CST]*-200.00*0**00535584 TRANSFER TO 780750 ON 2/16/23 A T 17:51,02/16/2023,00535584 TRANSFER TO 780750 ON 2/16/23 A T 17:51,,-200.0,,44133.86,,0.0,Personal
345,20230216000000[-6:CST]*-3.49*0**ATM WITHDRAWAL FEE XX3498 ATM WITHDRAWAL . 119 MAIN ST AMES IA RT35199 009593,02/16/2023,ATM WITHDRAWAL FEE XX3498 ATM WITHDRAWAL . 119 MAIN ST AMES IA RT35199 009593,,-3.49,,44333.86,,0.0,Personal
346,20230215000000[-6:CST]*-51.40*0**XX3498 POS WITHDRAWAL. Wal-Mart Super C AMES IA 07490049 304652000423,02/15/2023,XX3498 POS WITHDRAWAL. Wal-Mart Super C AMES IA 07490049 304652000423,,-51.4,,44337.35,,0.0,Groceries
347,20230214000000[-6:CST]*3.09*501**Interest paid,02/14/2023,Interest paid,,,3.09,44388.75,,0.0,Deposit
348,20230214000000[-6:CST]*-275.30*0**VERIZON WIRELESS PAYMENTS 05885909720000 1,02/14/2023,VERIZON WIRELESS PAYMENTS 05885909720000 1,,-275.3,,44385.66,,0.0,Bills & Utilities
349,20230213000000[-6:CST]*-253.88*0**Alliant - IPL PAYMENT 3836938783,02/13/2023,Alliant - IPL PAYMENT 3836938783,,-253.88,,44660.96,,0.0,Bills & Utilities
350,20230213000000[-6:CST]*-115.04*0**XX3498 POS WITHDRAWAL. WAL-MART #749 AME S IA 600001 062307,02/13/2023,XX3498 POS WITHDRAWAL. WAL-MART #749 AME S IA 600001 062307,,-115.04,,44914.84,,0.0,Groceries
351,20230213000000[-6:CST]*-28.00*0**XX3498 POS PURCHASE AT DES MOINES AIRPO DES MOINES IA 14638527 550236,02/13/2023,XX3498 POS PURCHASE AT DES MOINES AIRPO DES MOINES IA 14638527 550236,,-28.0,,45029.88,,0.0,Travel
352,20230213000000[-6:CST]*-6.00*0**XX3498 POS PURCHASE AT SUPER SHINE AMES AMES IA 60602337 489519,02/13/2023,XX3498 POS PURCHASE AT SUPER SHINE AMES AMES IA 60602337 489519,,-6.0,,45057.88,,0.0,Automotive
353,20230213000000[-6:CST]*-100.00*0**TRANSFER TO FREE CHECKING ACCOUNT XXXXXX 0750,02/13/2023,TRANSFER TO FREE CHECKING ACCOUNT XXXXXX 0750,,-100.0,,45063.88,,0.0,Personal
354,20230210000000[-6:CST]*-57.62*0**XX3498 POS PURCHASE AT CASEYS #2905 AMES IA 600001 031670,02/10/2023,XX3498 POS PURCHASE AT CASEYS #2905 AMES IA 600001 031670,,-57.62,,45163.88,,0.0,Gas
355,20230208000000[-6:CST]*-91.58*0**XX3498 POS PURCHASE AT PERFECT GAMES AME S IA 54320112 439933,02/08/2023,XX3498 POS PURCHASE AT PERFECT GAMES AME S IA 54320112 439933,,-91.58,,45221.5,,0.0,Entertainment
356,20230206000000[-6:CST]*-3740.06*0**CHASE CREDIT CRD AUTOPAY 000000000173180,02/06/2023,CHASE CREDIT CRD AUTOPAY 000000000173180,,-3740.06,,45313.08,,0.0,Bills & Utilities
357,20230206000000[-6:CST]*-712.75*0**IOWA BANKERS MTG ACH PMT XXXXXX2430,02/06/2023,IOWA BANKERS MTG ACH PMT XXXXXX2430,,-712.75,,49053.14,,0.0,Home
358,20230206000000[-6:CST]*-200.00*0**XX3498 ATM WITHDRAWAL. 3334 LINCOLN WAY AMES IA IA000623 001040,02/06/2023,XX3498 ATM WITHDRAWAL. 3334 LINCOLN WAY AMES IA IA000623 001040,,-200.0,,49765.89,,0.0,Personal
359,20230206000000[-6:CST]*-52.31*0**XX3498 POS WITHDRAWAL. WAL-MART #749 AME S IA 600001 050918,02/06/2023,XX3498 POS WITHDRAWAL. WAL-MART #749 AME S IA 600001 050918,,-52.31,,49965.89,,0.0,Groceries
360,20230206000000[-6:CST]*-49.00*0**XX3498 POS WITHDRAWAL. WHEATSFIELD COOP AMES IA 68087201 872969,02/06/2023,XX3498 POS WITHDRAWAL. WHEATSFIELD COOP AMES IA 68087201 872969,,-49.0,,50018.2,,0.0,Groceries
361,20230206000000[-6:CST]*-29.69*0**XX3498 POS PURCHASE AT SQ *BLUE FISH HA Ames IA 50827220 979099,02/06/2023,XX3498 POS PURCHASE AT SQ *BLUE FISH HA Ames IA 50827220 979099,,-29.69,,50067.2,,0.0,Food & Drink
362,20230203000000[-6:CST]*3737.46*501**DONNELLEY FINANC DIRECT DEP 551064827457 L5Z,02/03/2023,DONNELLEY FINANC DIRECT DEP 551064827457 L5Z,,,3737.46,50096.89,,0.0,Deposit
363,20230202000000[-6:CST]*-30.00*0**XX3498 POS PURCHASE AT SQ *THE ANGRY IR Ames IA 07917889 330724,02/02/2023,XX3498 POS PURCHASE AT SQ *THE ANGRY IR Ames IA 07917889 330724,,-30.0,,46359.43,,0.0,Food & Drink
364,20230202000000[-6:CST]*-140.00*0**Miscellaneous Debit,02/02/2023,Miscellaneous Debit,,-140.0,,46389.43,,0.0,Personal
365,20230202000000[-6:CST]*300.00*501**Deposit,02/02/2023,Deposit,,,300.0,46529.43,,0.0,Deposit
366,20230201000000[-6:CST]*-82.60*0**XX3498 POS WITHDRAWAL. WAL-MART #749 AME S IA 600001 029242,02/01/2023,XX3498 POS WITHDRAWAL. WAL-MART #749 AME S IA 600001 029242,,-82.6,,46229.43,,0.0,Groceries
367,20230201000000[-6:CST]*-44.21*0**XX3498 POS WITHDRAWAL. HY VEE 1013 AMES IA 1 922279,02/01/2023,XX3498 POS WITHDRAWAL. HY VEE 1013 AMES IA 1 922279,,-44.21,,46312.03,,0.0,Groceries
368,20230201000000[-6:CST]*-12.18*0**XX3498 POS WITHDRAWAL. MCDONALD'S M2021 AMES IA 81545316 848443,02/01/2023,XX3498 POS WITHDRAWAL. MCDONALD'S M2021 AMES IA 81545316 848443,,-12.18,,46356.24,,0.0,Food & Drink
369,20230131000000[-6:CST]*-45.00*0**VENMO PAYMENT 1024995281172,01/31/2023,VENMO PAYMENT 1024995281172,,-45.0,,46368.42,,0.0,Personal
370,20230131000000[-6:CST]*-46.18*0**XX3498 POS PURCHASE AT PERFECT GAMES AME S IA 57365773 420475,01/31/2023,XX3498 POS PURCHASE AT PERFECT GAMES AME S IA 57365773 420475,,-46.18,,46413.42,,0.0,Entertainment
371,20230131000000[-6:CST]*-18.00*0**XX3498 POS WITHDRAWAL. WHEATSFIELD COOP AMES IA 68087201 615341,01/31/2023,XX3498 POS WITHDRAWAL. WHEATSFIELD COOP AMES IA 68087201 615341,,-18.0,,46459.6,,0.0,Groceries
372,20230130000000[-6:CST]*-49.01*0**XX3498 POS PURCHASE AT LA CASA MAYA AMES IA 02604483 118549,01/30/2023,XX3498 POS PURCHASE AT LA CASA MAYA AMES IA 02604483 118549,,-49.01,,46477.6,,0.0,Food & Drink
373,20230127000000[-6:CST]*-79.11*0**CITY OF AMES UT BILL 002629810006826,01/27/2023,CITY OF AMES UT BILL 002629810006826,,-79.11,,46526.61,,0.0,Bills & Utilities
374,20230126000000[-6:CST]*-17.90*0**XX3498 POS PURCHASE AT TAZA MEDITERRANE AMES IA 69000396 598038,01/26/2023,XX3498 POS PURCHASE AT TAZA MEDITERRANE AMES IA 69000396 598038,,-17.9,,46605.72,,0.0,Food & Drink
375,20230125000000[-6:CST]*-39.10*0**XX3498 POS WITHDRAWAL. WM SUPERCENTER # AMES IA 600001 006834,01/25/2023,XX3498 POS WITHDRAWAL. WM SUPERCENTER # AMES IA 600001 006834,,-39.1,,46623.62,,0.0,Shopping
376,20230125000000[-6:CST]*-28.89*0**XX3498 POS WITHDRAWAL. HY VEE 1013 AMES IA 1 104547,01/25/2023,XX3498 POS WITHDRAWAL. HY VEE 1013 AMES IA 1 104547,,-28.89,,46662.72,,0.0,Groceries
377,20230125000000[-6:CST]*-21.62*0**XX3498 POS WITHDRAWAL. HY VEE 1018 AMES IA 1 532402,01/25/2023,XX3498 POS WITHDRAWAL. HY VEE 1018 AMES IA 1 532402,,-21.62,,46691.61,,0.0,Groceries
378,20230124000000[-6:CST]*-113.61*0**CITY OF AMES UT BILL 002819790003022,01/24/2023,CITY OF AMES UT BILL 002819790003022,,-113.61,,46713.23,,0.0,Bills & Utilities
379,20230124000000[-6:CST]*-27.90*0**XX3498 POS WITHDRAWAL. HY VEE 1018 AMES IA 1 143957,01/24/2023,XX3498 POS WITHDRAWAL. HY VEE 1018 AMES IA 1 143957,,-27.9,,46826.84,,0.0,Groceries
380,20230124000000[-6:CST]*-25.26*0**XX3498 POS WITHDRAWAL. Wal-Mart Super C AMES IA 07490046 302436520608,01/24/2023,XX3498 POS WITHDRAWAL. Wal-Mart Super C AMES IA 07490046 302436520608,,-25.26,,46854.74,,0.0,Groceries
381,20230124000000[-6:CST]*-7.46*0**XX3498 POS WITHDRAWAL. MCDONALD'S M2021 AMES IA 81545316 754422,01/24/2023,XX3498 POS WITHDRAWAL. MCDONALD'S M2021 AMES IA 81545316 754422,,-7.46,,46880.0,,0.0,Food & Drink
382,20230124000000[-6:CST]*-200.00*0**00191621 TRANSFER TO 780750 ON 1/24/23 A T 14:00,01/24/2023,00191621 TRANSFER TO 780750 ON 1/24/23 A T 14:00,,-200.0,,46887.46,,0.0,Personal
383,20230123000000[-6:CST]*-588.14*0**FARMERS INS EFT PYMT mXXXXX5868,01/23/2023,FARMERS INS EFT PYMT mXXXXX5868,,-588.14,,47087.46,,0.0,Automotive
384,20230123000000[-6:CST]*-55.00*0**VENMO PAYMENT 1024847821096,01/23/2023,VENMO PAYMENT 1024847821096,,-55.0,,47675.6,,0.0,Personal
385,20230123000000[-6:CST]*-22.97*0**XX3498 POS WITHDRAWAL. HY VEE 1018 AMES IA 1 326671,01/23/2023,XX3498 POS WITHDRAWAL. HY VEE 1018 AMES IA 1 326671,,-22.97,,47730.6,,0.0,Groceries
386,20230120000000[-6:CST]*-75.00*0**VENMO PAYMENT 1024791501673,01/20/2023,VENMO PAYMENT 1024791501673,,-75.0,,47753.57,,0.0,Personal
387,20230120000000[-6:CST]*-31.10*0**XX3498 POS WITHDRAWAL. HY VEE 1018 AMES IA 1 798850,01/20/2023,XX3498 POS WITHDRAWAL. HY VEE 1018 AMES IA 1 798850,,-31.1,,47828.57,,0.0,Groceries
388,20230120000000[-6:CST]*3737.44*501**DONNELLEY FINANC DIRECT DEP 739063518338 L5Z,01/20/2023,DONNELLEY FINANC DIRECT DEP 739063518338 L5Z,,,3737.44,47859.67,,0.0,Deposit
389,20230119000000[-6:CST]*-218.96*0**Alliant - IPL PAYMENT 0061467186,01/19/2023,Alliant - IPL PAYMENT 0061467186,,-218.96,,44122.23,,0.0,Bills & Utilities
390,20230119000000[-6:CST]*-81.26*0**XX3498 POS WITHDRAWAL. FAREWAY STORES # AMES IA 92405501 097100,01/19/2023,XX3498 POS WITHDRAWAL. FAREWAY STORES # AMES IA 92405501 097100,,-81.26,,44341.19,,0.0,Groceries
391,20230119000000[-6:CST]*-25.70*0**XX3498 POS PURCHASE AT PERFECT GAMES AME S IA 47559903 616301,01/19/2023,XX3498 POS PURCHASE AT PERFECT GAMES AME S IA 47559903 616301,,-25.7,,44422.45,,0.0,Entertainment
392,20230117000000[-6:CST]*-280.67*0**VERIZON WIRELESS PAYMENTS 05885909720000 1,01/17/2023,VERIZON WIRELESS PAYMENTS 05885909720000 1,,-280.67,,44448.15,,0.0,Bills & Utilities
393,20230117000000[-6:CST]*-24.60*0**CLUB FEES PLANET FIT 515-620-8880,01/17/2023,CLUB FEES PLANET FIT 515-620-8880,,-24.6,,44728.82,,0.0,Personal
394,20230117000000[-6:CST]*-100.00*0**XX3498 POS WITHDRAWAL. WHEATSFIELD COOP AMES IA 68087201 465176,01/17/2023,XX3498 POS WITHDRAWAL. WHEATSFIELD COOP AMES IA 68087201 465176,,-100.0,,44753.42,,0.0,Groceries
395,20230117000000[-6:CST]*-84.94*0**XX3498 POS WITHDRAWAL. WAL-MART #749 AME S IA 600001 035454,01/17/2023,XX3498 POS WITHDRAWAL. WAL-MART #749 AME S IA 600001 035454,,-84.94,,44853.42,,0.0,Groceries
396,20230117000000[-6:CST]*-59.18*0**XX3498 POS WITHDRAWAL. WAL-MART #749 AME S IA 600001 021572,01/17/2023,XX3498 POS WITHDRAWAL. WAL-MART #749 AME S IA 600001 021572,,-59.18,,44938.36,,0.0,Groceries
397,20230117000000[-6:CST]*-37.31*0**XX3498 POS PURCHASE AT SQ *BLUE FISH HA Ames IA 94293954 499698,01/17/2023,XX3498 POS PURCHASE AT SQ *BLUE FISH HA Ames IA 94293954 499698,,-37.31,,44997.54,,0.0,Food & Drink
398,20230117000000[-6:CST]*-23.06*0**XX3498 POS PURCHASE AT PHO  TEA CAFE L AMES IA 13000410 152307,01/17/2023,XX3498 POS PURCHASE AT PHO & TEA CAFE L AMES IA 13000410 152307,,-23.06,,45034.85,,0.0,Food & Drink
399,20230117000000[-6:CST]*-18.00*0**XX3498 POS PURCHASE AT THE SALVATION AR AMES IA 70713103 933625,01/17/2023,XX3498 POS PURCHASE AT THE SALVATION AR AMES IA 70713103 933625,,-18.0,,45057.91,,0.0,Home
400,20230113000000[-6:CST]*-35.30*0**XX3498 POS WITHDRAWAL. HY VEE 1013 AMES IA 1 622333,01/13/2023,XX3498 POS WITHDRAWAL. HY VEE 1013 AMES IA 1 622333,,-35.3,,45075.91,,0.0,Groceries
401,20230112000000[-6:CST]*-20.00*0**XX3498 POS WITHDRAWAL. HY VEE CLINIC 30 AMES IA 001 189463,01/12/2023,XX3498 POS WITHDRAWAL. HY VEE CLINIC 30 AMES IA 001 189463,,-20.0,,45111.21,,0.0,Groceries
402,20230112000000[-6:CST]*-15.56*0**XX3498 POS WITHDRAWAL. WAL-MART #0749 AM ES IA 24074901 668833,01/12/2023,XX3498 POS WITHDRAWAL. WAL-MART #0749 AM ES IA 24074901 668833,,-15.56,,45131.21,,0.0,Groceries
403,20230111000000[-6:CST]*-185.78*0**Alliant - IPL PAYMENT 3836938783,01/11/2023,Alliant - IPL PAYMENT 3836938783,,-185.78,,45146.77,,0.0,Bills & Utilities
404,20230111000000[-6:CST]*-77.55*0**ASPEN WASTE SYST EFT PMT 8 00257691,01/11/2023,ASPEN WASTE SYST EFT PMT 8 00257691,,-77.55,,45332.55,,0.0,Bills & Utilities
405,20230111000000[-6:CST]*-77.56*0**XX3498 POS WITHDRAWAL. Wal-Mart Super C AMES IA 07490050 301111002418,01/11/2023,XX3498 POS WITHDRAWAL. Wal-Mart Super C AMES IA 07490050 301111002418,,-77.56,,45410.1,,0.0,Groceries
406,20230111000000[-6:CST]*-37.00*0**XX3498 POS PURCHASE AT SQ *LONDON UNDER Ames IA 32583874 579056,01/11/2023,XX3498 POS PURCHASE AT SQ *LONDON UNDER Ames IA 32583874 579056,,-37.0,,45487.66,,0.0,Food & Drink
407,20230110000000[-6:CST]*2.04*501**Interest paid,01/10/2023,Interest paid,,,2.04,45524.66,,0.0,Deposit
408,20230110000000[-6:CST]*-802.00*0**DHS CSRU IOW DHS IOWDHS012276713,01/10/2023,DHS CSRU IOW DHS IOWDHS012276713,,-802.0,,45522.62,,0.0,Bills & Utilities
409,20230110000000[-6:CST]*-0.29*0**DHS CSRU conv fee IOWDHS012276714,01/10/2023,DHS CSRU conv fee IOWDHS012276714,,-0.29,,46324.62,,0.0,Bills & Utilities
410,20230110000000[-6:CST]*-9.95*0**XX3498 POS PURCHASE AT CULVERS OF AMES A MES IA 00426479 537292,01/10/2023,XX3498 POS PURCHASE AT CULVERS OF AMES A MES IA 00426479 537292,,-9.95,,46324.91,,0.0,Food & Drink
411,20230109000000[-6:CST]*-57.65*0**XX3498 POS WITHDRAWAL. HY VEE 1018 AMES IA 1 093391,01/09/2023,XX3498 POS WITHDRAWAL. HY VEE 1018 AMES IA 1 093391,,-57.65,,46334.86,,0.0,Groceries
412,20230106000000[-6:CST]*-1983.82*0**CHASE CREDIT CRD AUTOPAY 000000000172311,01/06/2023,CHASE CREDIT CRD AUTOPAY 000000000172311,,-1983.82,,46392.51,,0.0,Bills & Utilities
413,20230106000000[-6:CST]*-400.00*0**VENMO PAYMENT 1024535828562,01/06/2023,VENMO PAYMENT 1024535828562,,-400.0,,48376.33,,0.0,Personal
414,20230106000000[-6:CST]*-28.89*0**XX3498 POS WITHDRAWAL. HY VEE 1018 AMES IA 1 449482,01/06/2023,XX3498 POS WITHDRAWAL. HY VEE 1018 AMES IA 1 449482,,-28.89,,48776.33,,0.0,Groceries
415,20230106000000[-6:CST]*3737.43*501**DONNELLEY FINANC DIRECT DEP 653082996898 L5Z,01/06/2023,DONNELLEY FINANC DIRECT DEP 653082996898 L5Z,,,3737.43,48805.22,,0.0,Deposit
416,20230105000000[-6:CST]*-712.75*0**IOWA BANKERS MTG ACH PMT XXXXXX2430,01/05/2023,IOWA BANKERS MTG ACH PMT XXXXXX2430,,-712.75,,45067.79,,0.0,Home
417,20230105000000[-6:CST]*-39.00*0**XX3498 POS WITHDRAWAL. WHEATSFIELD COOP AMES IA 68087201 453786,01/05/2023,XX3498 POS WITHDRAWAL. WHEATSFIELD COOP AMES IA 68087201 453786,,-39.0,,45780.54,,0.0,Groceries
418,20230104000000[-6:CST]*-29.00*0**XX3498 POS PURCHASE AT THE SALVATION AR AMES IA 40624469 447475,01/04/2023,XX3498 POS PURCHASE AT THE SALVATION AR AMES IA 40624469 447475,,-29.0,,45819.54,,0.0,Home
419,20230104000000[-6:CST]*-23.42*0**XX3498 POS WITHDRAWAL. HY VEE 1018 AMES IA 1 873469,01/04/2023,XX3498 POS WITHDRAWAL. HY VEE 1018 AMES IA 1 873469,,-23.42,,45848.54,,0.0,Groceries
420,20230103000000[-6:CST]*-81.93*0**XX3498 POS WITHDRAWAL. Wal-Mart Super C AMES IA 07490046 300320002796,01/03/2023,XX3498 POS WITHDRAWAL. Wal-Mart Super C AMES IA 07490046 300320002796,,-81.93,,45871.96,,0.0,Groceries
421,20230103000000[-6:CST]*-8.83*0**XX3498 POS PURCHASE AT NORTH GRAND CINE AMES IA 65035558 293614,01/03/2023,XX3498 POS PURCHASE AT NORTH GRAND CINE AMES IA 65035558 293614,,-8.83,,45953.89,,0.0,Entertainment
422,20230103000000[-6:CST]*10000.00*501**XX3498 CHECK DEPOSIT.. 405 5TH ST AMES I A IA000619 004422,01/03/2023,XX3498 CHECK DEPOSIT.. 405 5TH ST AMES I A IA000619 004422,,,10000.0,45962.72,,0.0,Deposit
423,20221229000000[-6:CST]*-66.24*0**CITY OF AMES UT BILL 002629810006826,12/29/2022,CITY OF AMES UT BILL 002629810006826,,-66.24,,35962.72,,0.0,Bills & Utilities
424,20221229000000[-6:CST]*-36.00*0**XX3498 POS WITHDRAWAL. HY VEE 1018 AMES IA 1 165438,12/29/2022,XX3498 POS WITHDRAWAL. HY VEE 1018 AMES IA 1 165438,,-36.0,,36028.96,,0.0,Groceries
425,20221228000000[-6:CST]*-105.62*0**CITY OF AMES UT BILL 002819790003022,12/28/2022,CITY OF AMES UT BILL 002819790003022,,-105.62,,36064.96,,0.0,Bills & Utilities
426,20221228000000[-6:CST]*-44.00*0**XX3498 POS WITHDRAWAL. WHEATSFIELD COOP AMES IA 68087201 643893,12/28/2022,XX3498 POS WITHDRAWAL. WHEATSFIELD COOP AMES IA 68087201 643893,,-44.0,,36170.58,,0.0,Groceries
427,20221227000000[-6:CST]*-45.00*0**VENMO PAYMENT 1024339201996,12/27/2022,VENMO PAYMENT 1024339201996,,-45.0,,36214.58,,0.0,Personal
428,20221227000000[-6:CST]*-72.55*0**XX3498 POS WITHDRAWAL. HY VEE 1013 AMES IA 1 263297,12/27/2022,XX3498 POS WITHDRAWAL. HY VEE 1013 AMES IA 1 263297,,-72.55,,36259.58,,0.0,Groceries
429,20221227000000[-6:CST]*-25.66*0**XX3498 POS WITHDRAWAL. WALGREENS 2719 G AMES IA 12108T22 805466,12/27/2022,XX3498 POS WITHDRAWAL. WALGREENS 2719 G AMES IA 12108T22 805466,,-25.66,,36332.13,,0.0,Groceries
430,20221223000000[-6:CST]*-588.14*0**FARMERS INS EFT PYMT mXXXXX5868,12/23/2022,FARMERS INS EFT PYMT mXXXXX5868,,-588.14,,36357.79,,0.0,Automotive
431,20221223000000[-6:CST]*-100.00*0**VENMO PAYMENT 1024278608710,12/23/2022,VENMO PAYMENT 1024278608710,,-100.0,,36945.93,,0.0,Personal
432,20221223000000[-6:CST]*-59.47*0**XX3498 POS WITHDRAWAL. CYCLONE L 626 LI AMES IA 94367102 020673,12/23/2022,XX3498 POS WITHDRAWAL. CYCLONE L 626 LI AMES IA 94367102 020673,,-59.47,,37045.93,,0.0,Food & Drink
433,20221223000000[-6:CST]*-43.14*0**XX3498 POS WITHDRAWAL. TARGET T-1170 Ame s IA 600001 020105,12/23/2022,XX3498 POS WITHDRAWAL. TARGET T-1170 Ame s IA 600001 020105,,-43.14,,37105.4,,0.0,Shopping
434,20221223000000[-6:CST]*-25.00*0**XX3498 POS WITHDRAWAL. WHEATSFIELD COOP AMES IA 68087201 120208,12/23/2022,XX3498 POS WITHDRAWAL. WHEATSFIELD COOP AMES IA 68087201 120208,,-25.0,,37148.54,,0.0,Groceries
435,20221223000000[-6:CST]*-340.00*0**Miscellaneous Debit,12/23/2022,Miscellaneous Debit,,-340.0,,37173.54,,0.0,Personal
436,20221223000000[-6:CST]*4688.18*501**DONNELLEY FINANC DIRECT DEP 943424152660 L5Z,12/23/2022,DONNELLEY FINANC DIRECT DEP 943424152660 L5Z,,,4688.18,37513.54,,0.0,Deposit
437,20221221000000[-6:CST]*-124.75*0**Alliant - IPL PAYMENT 0061467186,12/21/2022,Alliant - IPL PAYMENT 0061467186,,-124.75,,32825.36,,0.0,Bills & Utilities
438,20221221000000[-6:CST]*-35.00*0**VENMO PAYMENT 1024234383531,12/21/2022,VENMO PAYMENT 1024234383531,,-35.0,,32950.11,,0.0,Personal
439,20221221000000[-6:CST]*-188.40*0**XX3498 POS WITHDRAWAL. HY VEE 1018 AMES IA 1 320169,12/21/2022,XX3498 POS WITHDRAWAL. HY VEE 1018 AMES IA 1 320169,,-188.4,,32985.11,,0.0,Groceries
440,20221220000000[-6:CST]*-80.00*0**XX3498 POS WITHDRAWAL. HY VEE 1018 AMES IA 1 870268,12/20/2022,XX3498 POS WITHDRAWAL. HY VEE 1018 AMES IA 1 870268,,-80.0,,33173.51,,0.0,Groceries
441,20221220000000[-6:CST]*-64.80*0**XX3498 POS PURCHASE AT PERFECT GAMES AME S IA 05090010 384607,12/20/2022,XX3498 POS PURCHASE AT PERFECT GAMES AME S IA 05090010 384607,,-64.8,,33253.51,,0.0,Entertainment
442,20221220000000[-6:CST]*-22.45*0**XX3498 POS WITHDRAWAL. JOANN FABRIC #16 AMES IA 08762969 244718,12/20/2022,XX3498 POS WITHDRAWAL. JOANN FABRIC #16 AMES IA 08762969 244718,,-22.45,,33318.31,,0.0,Shopping
443,20221219000000[-6:CST]*-24.60*0**CLUB FEES PLANET FIT 515-620-8880,12/19/2022,CLUB FEES PLANET FIT 515-620-8880,,-24.6,,33340.76,,0.0,Personal
444,20221219000000[-6:CST]*-105.00*0**XX3498 POS PURCHASE AT SQ *ACPS Ames IA 20543133 994758,12/19/2022,XX3498 POS PURCHASE AT SQ *ACPS Ames IA 20543133 994758,,-105.0,,33365.36,,0.0,Entertainment
445,20221219000000[-6:CST]*-16.00*0**XX3498 POS PURCHASE AT GOODWILL AMES AME S IA 99700096 970375,12/19/2022,XX3498 POS PURCHASE AT GOODWILL AMES AME S IA 99700096 970375,,-16.0,,33470.36,,0.0,Home
446,20221214000000[-6:CST]*-265.21*0**VERIZON WIRELESS PAYMENTS 05885909720000 1,12/14/2022,VERIZON WIRELESS PAYMENTS 05885909720000 1,,-265.21,,33486.36,,0.0,Bills & Utilities
447,20221214000000[-6:CST]*-128.32*0**Alliant - IPL PAYMENT 3836938783,12/14/2022,Alliant - IPL PAYMENT 3836938783,,-128.32,,33751.57,,0.0,Bills & Utilities
448,20221214000000[-6:CST]*-15.50*0**XX3498 POS PURCHASE AT SQ *LONDON UNDER Ames IA 04750156 268568,12/14/2022,XX3498 POS PURCHASE AT SQ *LONDON UNDER Ames IA 04750156 268568,,-15.5,,33879.89,,0.0,Food & Drink
449,20221214000000[-6:CST]*-14.43*0**XX3498 POS WITHDRAWAL. PAMMEL GROCERY AM ES IA 06747584 001482,12/14/2022,XX3498 POS WITHDRAWAL. PAMMEL GROCERY AM ES IA 06747584 001482,,-14.43,,33895.39,,0.0,Groceries
450,20221213000000[-6:CST]*2.12*501**Interest paid,12/13/2022,Interest paid,,,2.12,33909.82,,0.0,Deposit
451,20221213000000[-6:CST]*-125.93*0**XX3498 POS PURCHASE AT THE SPICE THAI C AMES IA 19900155 486551,12/13/2022,XX3498 POS PURCHASE AT THE SPICE THAI C AMES IA 19900155 486551,,-125.93,,33907.7,,0.0,Food & Drink
452,20221213000000[-6:CST]*-69.92*0**XX3498 POS PURCHASE AT PERFECT GAMES AME S IA 85666821 766415,12/13/2022,XX3498 POS PURCHASE AT PERFECT GAMES AME S IA 85666821 766415,,-69.92,,34033.63,,0.0,Entertainment
453,20221212000000[-6:CST]*-802.00*0**DHS CSRU IOW DHS IOWDHS012164909,12/12/2022,DHS CSRU IOW DHS IOWDHS012164909,,-802.0,,34103.55,,0.0,Bills & Utilities
454,20221212000000[-6:CST]*-0.29*0**DHS CSRU conv fee IOWDHS012164910,12/12/2022,DHS CSRU conv fee IOWDHS012164910,,-0.29,,34905.55,,0.0,Bills & Utilities
455,20221212000000[-6:CST]*-83.07*0**XX3498 POS WITHDRAWAL. Wal-Mart Super C AMES IA 07490046 234549000599,12/12/2022,XX3498 POS WITHDRAWAL. Wal-Mart Super C AMES IA 07490046 234549000599,,-83.07,,34905.84,,0.0,Groceries
456,20221212000000[-6:CST]*-20.07*0**XX3498 POS PURCHASE AT AJ S LIQUOR AMES IA 14800467 796051,12/12/2022,XX3498 POS PURCHASE AT AJ S LIQUOR AMES IA 14800467 796051,,-20.07,,34988.91,,0.0,Food & Drink
457,20221212000000[-6:CST]*250.00*501**XX3498 CHECK DEPOSIT.. 405 5TH ST AMES I A IA000619 004060,12/12/2022,XX3498 CHECK DEPOSIT.. 405 5TH ST AMES I A IA000619 004060,,,250.0,35008.98,,0.0,Deposit
458,20221209000000[-6:CST]*-24.37*0**XX3498 POS PURCHASE AT SQ *WOK N ROLL Am es IA 93347702 199755,12/09/2022,XX3498 POS PURCHASE AT SQ *WOK N ROLL Am es IA 93347702 199755,,-24.37,,34758.98,,0.0,Food & Drink
459,20221209000000[-6:CST]*4688.17*501**DONNELLEY FINANC DIRECT DEP 623084708323 L5Z,12/09/2022,DONNELLEY FINANC DIRECT DEP 623084708323 L5Z,,,4688.17,34783.35,,0.0,Deposit
460,20221208000000[-6:CST]*-280.25*0**CHECK DEPOSIT 3761720,12/08/2022,COUNTY TREASURER VEHICLE 3761720,,-280.25,,30095.18,,0.0,Bills & Utilities
461,20221208000000[-6:CST]*-107.66*0**XX3498 POS WITHDRAWAL. HY VEE 1013 AMES IA 1 171994,12/08/2022,XX3498 POS WITHDRAWAL. HY VEE 1013 AMES IA 1 171994,,-107.66,,30375.43,,0.0,Groceries
462,20221208000000[-6:CST]*-50.00*0**XX3498 POS PURCHASE AT ISU SURPLUS AMES IA 09000256 851427,12/08/2022,XX3498 POS PURCHASE AT ISU SURPLUS AMES IA 09000256 851427,,-50.0,,30483.09,,0.0,Shopping
463,20221208000000[-6:CST]*-48.29*0**XX3498 POS PURCHASE AT PERFECT GAMES AME S IA 81405120 068277,12/08/2022,XX3498 POS PURCHASE AT PERFECT GAMES AME S IA 81405120 068277,,-48.29,,30533.09,,0.0,Entertainment
464,20221208000000[-6:CST]*-29.42*0**XX3498 POS PURCHASE AT SQ *ICHIBAN Ames IA 57891119 654024,12/08/2022,XX3498 POS PURCHASE AT SQ *ICHIBAN Ames IA 57891119 654024,,-29.42,,30581.38,,0.0,Food & Drink
465,20221207000000[-6:CST]*-20.00*0**XX3498 POS WITHDRAWAL. HY VEE CLINIC 30 AMES IA 001 371269,12/07/2022,XX3498 POS WITHDRAWAL. HY VEE CLINIC 30 AMES IA 001 371269,,-20.0,,30610.8,,0.0,Groceries
466,20221207000000[-6:CST]*-15.45*0**XX3498 POS WITHDRAWAL. LOWE'S #581 AMES IA 001 117855,12/07/2022,XX3498 POS WITHDRAWAL. LOWE'S #581 AMES IA 001 117855,,-15.45,,30630.8,,0.0,Home
467,20221206000000[-6:CST]*-3024.41*0**CHASE CREDIT CRD AUTOPAY 000000000171904,12/06/2022,CHASE CREDIT CRD AUTOPAY 000000000171904,,-3024.41,,30646.25,,0.0,Bills & Utilities
468,20221206000000[-6:CST]*-136.00*0**XX3498 POS WITHDRAWAL. WHEATSFIELD COOP AMES IA 68087201 100511,12/06/2022,XX3498 POS WITHDRAWAL. WHEATSFIELD COOP AMES IA 68087201 100511,,-136.0,,33670.66,,0.0,Groceries
469,20221206000000[-6:CST]*-35.13*0**XX3498 POS PURCHASE AT LA CASA MAYA AMES IA 02604415 676477,12/06/2022,XX3498 POS PURCHASE AT LA CASA MAYA AMES IA 02604415 676477,,-35.13,,33806.66,,0.0,Food & Drink
470,20221206000000[-6:CST]*-28.49*0**XX3498 POS PURCHASE AT PERFECT GAMES AME S IA 85529713 936148,12/06/2022,XX3498 POS PURCHASE AT PERFECT GAMES AME S IA 85529713 936148,,-28.49,,33841.79,,0.0,Entertainment
471,20221205000000[-6:CST]*-712.75*0**IOWA BANKERS MTG ACH PMT XXXXXX2430,12/05/2022,IOWA BANKERS MTG ACH PMT XXXXXX2430,,-712.75,,33870.28,,0.0,Home
472,20221205000000[-6:CST]*-200.00*0**XX3498 ATM WITHDRAWAL. 2406 GRAND AVE AM ES IA IA000624 000580,12/05/2022,XX3498 ATM WITHDRAWAL. 2406 GRAND AVE AM ES IA IA000624 000580,,-200.0,,34583.03,,0.0,Personal
473,20221205000000[-6:CST]*-26.00*0**XX3498 POS PURCHASE AT SQ *LONDON UNDER Ames IA 34257929 926929,12/05/2022,XX3498 POS PURCHASE AT SQ *LONDON UNDER Ames IA 34257929 926929,,-26.0,,34783.03,,0.0,Food & Drink
474,20221205000000[-6:CST]*-25.00*0**XX3498 POS PURCHASE AT SQ *ACPS Ames IA 32541010 137903,12/05/2022,XX3498 POS PURCHASE AT SQ *ACPS Ames IA 32541010 137903,,-25.0,,34809.03,,0.0,Entertainment
475,20221205000000[-6:CST]*-21.06*0**XX3498 POS PURCHASE AT KWIK STOP LIQUOR AMES IA 98974413 460722,12/05/2022,XX3498 POS PURCHASE AT KWIK STOP LIQUOR AMES IA 98974413 460722,,-21.06,,34834.03,,0.0,Food & Drink
476,20221205000000[-6:CST]*-9.94*0**XX3498 POS PURCHASE AT CULVERS OF AMES A MES IA 00390813 967970,12/05/2022,XX3498 POS PURCHASE AT CULVERS OF AMES A MES IA 00390813 967970,,-9.94,,34855.09,,0.0,Food & Drink
477,20221205000000[-6:CST]*-9.00*0**XX3498 POS PURCHASE AT GOODWILL AMES AME S IA 99700145 067703,12/05/2022,XX3498 POS PURCHASE AT GOODWILL AMES AME S IA 99700145 067703,,-9.0,,34865.03,,0.0,Home
478,20221202000000[-6:CST]*-200.00*0**VENMO PAYMENT 1023848195410,12/02/2022,VENMO PAYMENT 1023848195410,,-200.0,,34874.03,,0.0,Personal
479,20221202000000[-6:CST]*-40.00*0**VENMO PAYMENT 1023849356330,12/02/2022,VENMO PAYMENT 1023849356330,,-40.0,,35074.03,,0.0,Personal
480,20221202000000[-6:CST]*-32.00*0**XX3498 POS PURCHASE AT SQ *LONDON UNDER Ames IA 00411596 622436,12/02/2022,XX3498 POS PURCHASE AT SQ *LONDON UNDER Ames IA 00411596 622436,,-32.0,,35114.03,,0.0,Food & Drink
481,20221202000000[-6:CST]*-12.07*0**XX3498 POS WITHDRAWAL. MCDONALD'S M2021 AMES IA 81545314 236184,12/02/2022,XX3498 POS WITHDRAWAL. MCDONALD'S M2021 AMES IA 81545314 236184,,-12.07,,35146.03,,0.0,Food & Drink
482,20221201000000[-6:CST]*-36.00*0**XX3498 POS PURCHASE AT SQ *THE ANGRY IR Ames IA 16321707 240287,12/01/2022,XX3498 POS PURCHASE AT SQ *THE ANGRY IR Ames IA 16321707 240287,,-36.0,,35158.1,,0.0,Food & Drink
483,20221201000000[-6:CST]*-10.37*0**XX3498 POS PURCHASE AT KWIK STOP LIQUOR AMES IA 07450238 112257,12/01/2022,XX3498 POS PURCHASE AT KWIK STOP LIQUOR AMES IA 07450238 112257,,-10.37,,35194.1,,0.0,Food & Drink
484,20221130000000[-6:CST]*-8.44*0**XX3498 POS WITHDRAWAL. MCDONALD'S M2021 AMES IA 81545314 899388,11/30/2022,XX3498 POS WITHDRAWAL. MCDONALD'S M2021 AMES IA 81545314 899388,,-8.44,,35204.47,,0.0,Food & Drink
485,20221129000000[-6:CST]*-64.00*0**XX3498 POS WITHDRAWAL. FAREWAY STORES # AMES IA 92405701 427800,11/29/2022,XX3498 POS WITHDRAWAL. FAREWAY STORES # AMES IA 92405701 427800,,-64.0,,35212.91,,0.0,Groceries
486,20221129000000[-6:CST]*-40.25*0**XX3498 POS PURCHASE AT PERFECT GAMES AME S IA 77140690 801669,11/29/2022,XX3498 POS PURCHASE AT PERFECT GAMES AME S IA 77140690 801669,,-40.25,,35276.91,,0.0,Entertainment
487,20221129000000[-6:CST]*-8.56*0**XX3498 POS PURCHASE AT PERFECT GAMES AME S IA 77140773 296446,11/29/2022,XX3498 POS PURCHASE AT PERFECT GAMES AME S IA 77140773 296446,,-8.56,,35317.16,,0.0,Entertainment
488,20221128000000[-6:CST]*-67.89*0**CITY OF AMES UT BILL 002629810006826,11/28/2022,CITY OF AMES UT BILL 002629810006826,,-67.89,,35325.72,,0.0,Bills & Utilities
489,20221128000000[-6:CST]*-11.00*0**XX3498 POS PURCHASE AT O DONNELL ACE HA AMES IA 77002543 834392,11/28/2022,XX3498 POS PURCHASE AT O DONNELL ACE HA AMES IA 77002543 834392,,-11.0,,35393.61,,0.0,Home
490,20221125000000[-6:CST]*-200.00*0**XX3498 ATM WITHDRAWAL. 405 5TH ST AMES I A IA000614 002094,11/25/2022,XX3498 ATM WITHDRAWAL. 405 5TH ST AMES I A IA000614 002094,,-200.0,,35404.61,,0.0,Personal
491,20221125000000[-6:CST]*-138.00*0**XX3498 POS WITHDRAWAL. HY VEE 1018 AMES IA 1 987763,11/25/2022,XX3498 POS WITHDRAWAL. HY VEE 1018 AMES IA 1 987763,,-138.0,,35604.61,,0.0,Groceries
492,20221125000000[-6:CST]*-63.14*0**XX3498 POS PURCHASE AT SQ *THAI KITCHEN Ames IA 75566628 275710,11/25/2022,XX3498 POS PURCHASE AT SQ *THAI KITCHEN Ames IA 75566628 275710,,-63.14,,35742.61,,0.0,Food & Drink
493,20221125000000[-6:CST]*-9.19*0**XX3498 POS WITHDRAWAL. KUMGO 0510 STUA STUART IA 001 663654,11/25/2022,XX3498 POS WITHDRAWAL. KUM&GO 0510 STUA STUART IA 001 663654,,-9.19,,35805.75,,0.0,Gas
494,20221125000000[-6:CST]*4474.25*501**DONNELLEY FINANC DIRECT DEP 417564143997 L5Z,11/25/2022,DONNELLEY FINANC DIRECT DEP 417564143997 L5Z,,,4474.25,35814.94,,0.0,Deposit
495,20221123000000[-6:CST]*-588.12*0**FARMERS INS EFT PYMT mXXXXX5868,11/23/2022,FARMERS INS EFT PYMT mXXXXX5868,,-588.12,,31340.69,,0.0,Automotive
496,20221123000000[-6:CST]*-98.67*0**CITY OF AMES UT BILL 002819790003022,11/23/2022,CITY OF AMES UT BILL 002819790003022,,-98.67,,31928.81,,0.0,Bills & Utilities
497,20221123000000[-6:CST]*-50.45*0**XX3498 POS PURCHASE AT SQ *CORNBRED BAR Ames IA 25248660 669234,11/23/2022,XX3498 POS PURCHASE AT SQ *CORNBRED BAR Ames IA 25248660 669234,,-50.45,,32027.48,,0.0,Food & Drink
498,20221123000000[-6:CST]*-30.33*0**XX3498 POS PURCHASE AT SQ *LOCKWOOD AMES IA 79788499 480295,11/23/2022,XX3498 POS PURCHASE AT SQ *LOCKWOOD AMES IA 79788499 480295,,-30.33,,32077.93,,0.0,Food & Drink
499,20221122000000[-6:CST]*-22.25*0**XX3498 POS PURCHASE AT PERFECT GAMES AME S IA 91860199 062889,11/22/2022,XX3498 POS PURCHASE AT PERFECT GAMES AME S IA 91860199 062889,,-22.25,,32108.26,,0.0,Entertainment
500,20221122000000[-6:CST]*-6.94*0**XX3498 POS PURCHASE AT PERFECT GAMES AME S IA 91860017 425559,11/22/2022,XX3498 POS PURCHASE AT PERFECT GAMES AME S IA 91860017 425559,,-6.94,,32130.51,,0.0,Entertainment
501,20221121000000[-6:CST]*-69.88*0**Alliant - IPL PAYMENT 0061467186,11/21/2022,Alliant - IPL PAYMENT 0061467186,,-69.88,,32137.45,,0.0,Bills & Utilities
502,20221121000000[-6:CST]*-25.00*0**XX3498 POS PURCHASE AT SQ *ACPS Ames IA 76160237 783895,11/21/2022,XX3498 POS PURCHASE AT SQ *ACPS Ames IA 76160237 783895,,-25.0,,32207.33,,0.0,Entertainment
503,20221118000000[-6:CST]*-110.70*0**XX3498 POS PURCHASE AT LA CASA MAYA AMES IA 02604472 165876,11/18/2022,XX3498 POS PURCHASE AT LA CASA MAYA AMES IA 02604472 165876,,-110.7,,32232.33,,0.0,Food & Drink
504,20221118000000[-6:CST]*-8.55*0**XX3498 POS WITHDRAWAL. MCDONALD'S M2021 AMES IA 81545314 565530,11/18/2022,XX3498 POS WITHDRAWAL. MCDONALD'S M2021 AMES IA 81545314 565530,,-8.55,,32343.03,,0.0,Food & Drink
505,20221117000000[-6:CST]*-35.00*0**VENMO PAYMENT 1023528217512,11/17/2022,VENMO PAYMENT 1023528217512,,-35.0,,32351.58,,0.0,Personal
506,20221117000000[-6:CST]*-24.60*0**CLUB FEES PLANET FIT 515-620-8880,11/17/2022,CLUB FEES PLANET FIT 515-620-8880,,-24.6,,32386.58,,0.0,Personal
507,20221116000000[-6:CST]*-239.74*0**VERIZON WIRELESS PAYMENTS 05885909720000 1,11/16/2022,VERIZON WIRELESS PAYMENTS 05885909720000 1,,-239.74,,32411.18,,0.0,Bills & Utilities
508,20221116000000[-6:CST]*-51.23*0**XX3498 POS WITHDRAWAL. HY VEE 1013 AMES IA 1 612089,11/16/2022,XX3498 POS WITHDRAWAL. HY VEE 1013 AMES IA 1 612089,,-51.23,,32650.92,,0.0,Groceries
509,20221116000000[-6:CST]*-12.07*0**XX3498 POS WITHDRAWAL. MCDONALD'S M2021 AMES IA 81545314 173743,11/16/2022,XX3498 POS WITHDRAWAL. MCDONALD'S M2021 AMES IA 81545314 173743,,-12.07,,32702.15,,0.0,Food & Drink
510,20221116000000[-6:CST]*-10.37*0**XX3498 POS WITHDRAWAL. HY VEE 1013 AMES IA 1 613045,11/16/2022,XX3498 POS WITHDRAWAL. HY VEE 1013 AMES IA 1 613045,,-10.37,,32714.22,,0.0,Groceries
511,20221115000000[-6:CST]*-50.44*0**XX3498 POS PURCHASE AT PERFECT GAMES AME S IA 63251491 447711,11/15/2022,XX3498 POS PURCHASE AT PERFECT GAMES AME S IA 63251491 447711,,-50.44,,32724.59,,0.0,Entertainment
512,20221115000000[-6:CST]*-37.58*0**XX3498 POS WITHDRAWAL. FAREWAY STORES # AMES IA 92405701 382500,11/15/2022,XX3498 POS WITHDRAWAL. FAREWAY STORES # AMES IA 92405701 382500,,-37.58,,32775.03,,0.0,Groceries
513,20221115000000[-6:CST]*-33.50*0**XX3498 POS WITHDRAWAL. IA DOT DRIVER SV AMES IA 80001995 446762773665,11/15/2022,XX3498 POS WITHDRAWAL. IA DOT DRIVER SV AMES IA 80001995 446762773665,,-33.5,,32812.61,,0.0,Automotive
514,20221114000000[-6:CST]*-70.67*0**Alliant - IPL PAYMENT 3836938783,11/14/2022,Alliant - IPL PAYMENT 3836938783,,-70.67,,32846.11,,0.0,Bills & Utilities
515,20221114000000[-6:CST]*-83.00*0**XX3498 POS WITHDRAWAL. HY VEE 1018 AMES IA 1 930249,11/14/2022,XX3498 POS WITHDRAWAL. HY VEE 1018 AMES IA 1 930249,,-83.0,,32916.78,,0.0,Groceries
516,20221114000000[-6:CST]*-33.17*0**XX3498 POS PURCHASE AT SQ *CORNBRED BAR Ames IA 70241033 959781,11/14/2022,XX3498 POS PURCHASE AT SQ *CORNBRED BAR Ames IA 70241033 959781,,-33.17,,32999.78,,0.0,Food & Drink
517,20221114000000[-6:CST]*-14.00*0**XX3498 POS PURCHASE AT GOODWILL AMES AME S IA 99700411 649414,11/14/2022,XX3498 POS PURCHASE AT GOODWILL AMES AME S IA 99700411 649414,,-14.0,,33032.95,,0.0,Home
518,20221114000000[-6:CST]*-13.36*0**XX3498 POS WITHDRAWAL. HY VEE 1013 AMES IA 1 366461,11/14/2022,XX3498 POS WITHDRAWAL. HY VEE 1013 AMES IA 1 366461,,-13.36,,33046.95,,0.0,Groceries
519,20221114000000[-6:CST]*-7.63*0**XX3498 POS WITHDRAWAL. KUMGO 1215 AMES AMES IA 001 549879,11/14/2022,XX3498 POS WITHDRAWAL. KUM&GO 1215 AMES AMES IA 001 549879,,-7.63,,33060.31,,0.0,Gas
520,20221114000000[-6:CST]*-200.00*0**00693755 TRANSFER TO 780750 ON 11/12/22 AT 17:23,11/14/2022,00693755 TRANSFER TO 780750 ON 11/12/22 AT 17:23,,-200.0,,33067.94,,0.0,Personal
521,20221114000000[-6:CST]*12486.53*501**PAYPAL TRANSFER 1023436764410,11/14/2022,PAYPAL TRANSFER 1023436764410,,,12486.53,33267.94,,0.0,Deposit
522,20221110000000[-6:CST]*-37.32*0**XX3498 POS WITHDRAWAL. PERKINS RESTAURA FARIBAULT MN 01888520 23149100253,11/10/2022,XX3498 POS WITHDRAWAL. PERKINS RESTAURA FARIBAULT MN 01888520 23149100253,,-37.32,,20781.41,,0.0,Travel
523,20221110000000[-6:CST]*4003.70*501**DONNELLEY FINANC DIRECT DEP 937423702570 L5Z,11/10/2022,DONNELLEY FINANC DIRECT DEP 937423702570 L5Z,,,4003.7,20818.73,,0.0,Deposit
524,20221108000000[-6:CST]*0.95*501**Interest paid,11/08/2022,Interest paid,,,0.95,16815.03,,0.0,Deposit
525,20221107000000[-6:CST]*-1261.39*0**CHASE CREDIT CRD AUTOPAY 000000000321054,11/07/2022,CHASE CREDIT CRD AUTOPAY 000000000321054,,-1261.39,,16814.08,,0.0,Bills & Utilities
526,20221107000000[-6:CST]*-712.75*0**IOWA BANKERS MTG ACH PMT XXXXXX2430,11/07/2022,IOWA BANKERS MTG ACH PMT XXXXXX2430,,-712.75,,18075.47,,0.0,Home
527,20221107000000[-6:CST]*-75.00*0**VENMO PAYMENT 1023345007869,11/07/2022,VENMO PAYMENT 1023345007869,,-75.0,,18788.22,,0.0,Personal
528,20221107000000[-6:CST]*-150.00*0**00060167 TRANSFER TO 780750 ON 11/07/22 AT 14:26,11/07/2022,00060167 TRANSFER TO 780750 ON 11/07/22 AT 14:26,,-150.0,,18863.22,,0.0,Personal
529,20221101000000[-6:CST]*-22.02*0**XX3498 POS PURCHASE AT BURGER KING #125 NORTHWOOD IA 93000519 314385,11/01/2022,XX3498 POS PURCHASE AT BURGER KING #125 NORTHWOOD IA 93000519 314385,,-22.02,,19013.22,,0.0,Food & Drink
530,20221031000000[-6:CST]*-106.25*0**VENMO PAYMENT 1023204123603,10/31/2022,VENMO PAYMENT 1023204123603,,-106.25,,19035.24,,0.0,Personal
531,20221031000000[-6:CST]*-25.00*0**XX3498 POS PURCHASE AT SQ *ACPS Ames IA 31699109 520986,10/31/2022,XX3498 POS PURCHASE AT SQ *ACPS Ames IA 31699109 520986,,-25.0,,19141.49,,0.0,Entertainment
532,20221028000000[-6:CST]*-802.00*0**DHS CSRU IOW DHS IOWDHS012007730,10/28/2022,DHS CSRU IOW DHS IOWDHS012007730,,-802.0,,19166.49,,0.0,Bills & Utilities
533,20221028000000[-6:CST]*-0.29*0**DHS CSRU conv fee IOWDHS012007731,10/28/2022,DHS CSRU conv fee IOWDHS012007731,,-0.29,,19968.49,,0.0,Bills & Utilities
534,20221028000000[-6:CST]*-63.00*0**XX3498 POS WITHDRAWAL. WHEATSFIELD COOP AMES IA 68087201 768096,10/28/2022,XX3498 POS WITHDRAWAL. WHEATSFIELD COOP AMES IA 68087201 768096,,-63.0,,19968.78,,0.0,Groceries
535,20221028000000[-6:CST]*-28.05*0**XX3498 POS WITHDRAWAL. HY VEE 1013 AMES IA 1 032812,10/28/2022,XX3498 POS WITHDRAWAL. HY VEE 1013 AMES IA 1 032812,,-28.05,,20031.78,,0.0,Groceries
536,20221028000000[-6:CST]*4003.69*501**DONNELLEY FINANC DIRECT DEP 756062893625 L5Z,10/28/2022,DONNELLEY FINANC DIRECT DEP 756062893625 L5Z,,,4003.69,20059.83,,0.0,Deposit
537,20221027000000[-6:CST]*-83.08*0**CITY OF AMES UT BILL 002629810006826,10/27/2022,CITY OF AMES UT BILL 002629810006826,,-83.08,,16056.14,,0.0,Bills & Utilities
538,20221027000000[-6:CST]*-57.91*0**XX3498 POS WITHDRAWAL. Wal-Mart Super C AMES IA 07490038 230019000455,10/27/2022,XX3498 POS WITHDRAWAL. Wal-Mart Super C AMES IA 07490038 230019000455,,-57.91,,16139.22,,0.0,Groceries
539,20221027000000[-6:CST]*-26.59*0**XX3498 POS WITHDRAWAL. HY VEE CLINIC 30 AMES IA 001 722571,10/27/2022,XX3498 POS WITHDRAWAL. HY VEE CLINIC 30 AMES IA 001 722571,,-26.59,,16197.13,,0.0,Groceries
540,20221027000000[-6:CST]*-200.00*0**Miscellaneous Debit,10/27/2022,Miscellaneous Debit,,-200.0,,16223.72,,0.0,Personal
541,20221025000000[-6:CST]*-54.53*0**XX3498 POS PURCHASE AT PERFECT GAMES AME S IA 04330867 728262,10/25/2022,XX3498 POS PURCHASE AT PERFECT GAMES AME S IA 04330867 728262,,-54.53,,16423.72,,0.0,Entertainment
542,"20221025000000[-6:CST]*-49.34*0**XX3498 POS WITHDRAWAL. FAREWAY STORES, A MES IA 68557501 489200",10/25/2022,"XX3498 POS WITHDRAWAL. FAREWAY STORES, A MES IA 68557501 489200",,-49.34,,16478.25,,0.0,Groceries
543,20221025000000[-6:CST]*-7.00*0**XX3498 POS PURCHASE AT WILD WATER CAR W AMES IA 67781636 891022,10/25/2022,XX3498 POS PURCHASE AT WILD WATER CAR W AMES IA 67781636 891022,,-7.0,,16527.59,,0.0,Automotive
544,20221024000000[-6:CST]*-631.03*0**FARMERS INS EFT PYMT mXXXXX5868,10/24/2022,FARMERS INS EFT PYMT mXXXXX5868,,-631.03,,16534.59,,0.0,Automotive
545,20221024000000[-6:CST]*-137.92*0**CITY OF AMES UT BILL 002819790003022,10/24/2022,CITY OF AMES UT BILL 002819790003022,,-137.92,,17165.62,,0.0,Bills & Utilities
546,20221024000000[-6:CST]*-200.00*0**XX3498 ATM WITHDRAWAL. 405 5TH ST AMES I A IA000614 000067,10/24/2022,XX3498 ATM WITHDRAWAL. 405 5TH ST AMES I A IA000614 000067,,-200.0,,17303.54,,0.0,Personal
547,20221024000000[-6:CST]*-10.50*0**XX3498 POS PURCHASE AT SUPER SHINE AMES AMES IA 98231022 179452,10/24/2022,XX3498 POS PURCHASE AT SUPER SHINE AMES AMES IA 98231022 179452,,-10.5,,17503.54,,0.0,Automotive
548,20221021000000[-6:CST]*-40.00*0**VENMO PAYMENT 1023020629779,10/21/2022,VENMO PAYMENT 1023020629779,,-40.0,,17514.04,,0.0,Personal
549,20221021000000[-6:CST]*-31.58*0**Alliant - IPL PAYMENT 0061467186,10/21/2022,Alliant - IPL PAYMENT 0061467186,,-31.58,,17554.04,,0.0,Bills & Utilities
550,20221021000000[-6:CST]*-41.24*0**XX3498 POS WITHDRAWAL. WAL-MART #0749 AM ES IA 24074901 360303,10/21/2022,XX3498 POS WITHDRAWAL. WAL-MART #0749 AM ES IA 24074901 360303,,-41.24,,17585.62,,0.0,Groceries
551,20221021000000[-6:CST]*-27.00*0**XX3498 POS WITHDRAWAL. WHEATSFIELD COOP AMES IA 68087201 368853,10/21/2022,XX3498 POS WITHDRAWAL. WHEATSFIELD COOP AMES IA 68087201 368853,,-27.0,,17626.86,,0.0,Groceries
552,20221020000000[-6:CST]*-42.31*0**XX3498 POS WITHDRAWAL. HY VEE 1013 AMES IA 1 401612,10/20/2022,XX3498 POS WITHDRAWAL. HY VEE 1013 AMES IA 1 401612,,-42.31,,17653.86,,0.0,Groceries
553,20221020000000[-6:CST]*-26.00*0**XX3498 POS PURCHASE AT SQ *THE ANGRY IR Ames IA 03811029 384801,10/20/2022,XX3498 POS PURCHASE AT SQ *THE ANGRY IR Ames IA 03811029 384801,,-26.0,,17696.17,,0.0,Food & Drink
554,20221020000000[-6:CST]*-13.28*0**XX3498 POS WITHDRAWAL. WALGREENS 2719 G AMES IA 12108T21 022965,10/20/2022,XX3498 POS WITHDRAWAL. WALGREENS 2719 G AMES IA 12108T21 022965,,-13.28,,17722.17,,0.0,Groceries
555,20221020000000[-6:CST]*-11.96*0**XX3498 POS PURCHASE AT SQ *LOCKWOOD AMES IA 46458682 927362,10/20/2022,XX3498 POS PURCHASE AT SQ *LOCKWOOD AMES IA 46458682 927362,,-11.96,,17735.45,,0.0,Food & Drink
556,20221018000000[-6:CST]*-52.25*0**XX3498 POS PURCHASE AT PERFECT GAMES AME S IA 03355992 332813,10/18/2022,XX3498 POS PURCHASE AT PERFECT GAMES AME S IA 03355992 332813,,-52.25,,17747.41,,0.0,Entertainment
557,20221018000000[-6:CST]*-40.00*0**XX3498 POS WITHDRAWAL. WHEATSFIELD COOP AMES IA 68087201 914831,10/18/2022,XX3498 POS WITHDRAWAL. WHEATSFIELD COOP AMES IA 68087201 914831,,-40.0,,17799.66,,0.0,Groceries
558,20221017000000[-6:CST]*-24.60*0**CLUB FEES PLANET FIT 515-620-8880,10/17/2022,CLUB FEES PLANET FIT 515-620-8880,,-24.6,,17839.66,,0.0,Personal
559,20221017000000[-6:CST]*-36.40*0**XX3498 POS WITHDRAWAL. HY VEE 1013 AMES IA 1 714839,10/17/2022,XX3498 POS WITHDRAWAL. HY VEE 1013 AMES IA 1 714839,,-36.4,,17864.26,,0.0,Groceries
560,20221017000000[-6:CST]*-25.00*0**XX3498 POS PURCHASE AT SQ *ACPS Ames IA 73049376 040912,10/17/2022,XX3498 POS PURCHASE AT SQ *ACPS Ames IA 73049376 040912,,-25.0,,17900.66,,0.0,Entertainment
561,20221017000000[-6:CST]*-21.44*0**XX3498 POS WITHDRAWAL. CYCLONE L 626 LI AMES IA 94367101 059652,10/17/2022,XX3498 POS WITHDRAWAL. CYCLONE L 626 LI AMES IA 94367101 059652,,-21.44,,17925.66,,0.0,Food & Drink
562,20221017000000[-6:CST]*-20.37*0**XX3498 POS WITHDRAWAL. KUMGO 1215 AMES AMES IA 001 621472,10/17/2022,XX3498 POS WITHDRAWAL. KUM&GO 1215 AMES AMES IA 001 621472,,-20.37,,17947.1,,0.0,Gas
563,20221017000000[-6:CST]*-18.25*0**XX3498 POS PURCHASE AT CULVERS OF AMES A MES IA 00279783 275233,10/17/2022,XX3498 POS PURCHASE AT CULVERS OF AMES A MES IA 00279783 275233,,-18.25,,17967.47,,0.0,Food & Drink
564,20221017000000[-6:CST]*-14.85*0**XX3498 POS WITHDRAWAL. HY VEE 1018 AMES IA 1 750061,10/17/2022,XX3498 POS WITHDRAWAL. HY VEE 1018 AMES IA 1 750061,,-14.85,,17985.72,,0.0,Groceries
565,20221017000000[-6:CST]*-150.00*0**00041978 TRANSFER TO 780750 ON 10/17/22 AT 11:43,10/17/2022,00041978 TRANSFER TO 780750 ON 10/17/22 AT 11:43,,-150.0,,18000.57,,0.0,Personal
566,20221014000000[-6:CST]*-240.17*0**VERIZON WIRELESS PAYMENTS 05885909720000 1,10/14/2022,VERIZON WIRELESS PAYMENTS 05885909720000 1,,-240.17,,18150.57,,0.0,Bills & Utilities
567,20221014000000[-6:CST]*-7.27*0**XX3498 POS WITHDRAWAL. MCDONALD'S M2021 AMES IA 81545314 028395,10/14/2022,XX3498 POS WITHDRAWAL. MCDONALD'S M2021 AMES IA 81545314 028395,,-7.27,,18390.74,,0.0,Food & Drink
568,20221014000000[-6:CST]*3749.30*501**DONNELLEY FINANC DIRECT DEP 796084862510 L5Z,10/14/2022,DONNELLEY FINANC DIRECT DEP 796084862510 L5Z,,,3749.3,18398.01,,0.0,Deposit
569,20221013000000[-6:CST]*-27.54*0**Alliant - IPL PAYMENT 3836938783,10/13/2022,Alliant - IPL PAYMENT 3836938783,,-27.54,,14648.71,,0.0,Bills & Utilities
570,20221012000000[-6:CST]*-77.55*0**ASPEN WASTE SYST EFT PMT 8 00257691,10/12/2022,ASPEN WASTE SYST EFT PMT 8 00257691,,-77.55,,14676.25,,0.0,Bills & Utilities
571,20221012000000[-6:CST]*-62.45*0**XX3498 POS WITHDRAWAL. HY VEE 1018 AMES IA 1 688917,10/12/2022,XX3498 POS WITHDRAWAL. HY VEE 1018 AMES IA 1 688917,,-62.45,,14753.8,,0.0,Groceries
572,20221012000000[-6:CST]*-33.21*0**XX3498 POS WITHDRAWAL. HY VEE 1013 AMES IA 1 766766,10/12/2022,XX3498 POS WITHDRAWAL. HY VEE 1013 AMES IA 1 766766,,-33.21,,14816.25,,0.0,Groceries
573,20221011000000[-6:CST]*1.26*501**Interest paid,10/11/2022,Interest paid,,,1.26,14849.46,,0.0,Deposit
574,20221011000000[-6:CST]*-2615.00*1*1042*Check,10/11/2022,Check,,-2615.0,,14848.2,1042.0,0.0,Personal
575,20221011000000[-6:CST]*-400.00*0**VENMO PAYMENT 1022783798838,10/11/2022,VENMO PAYMENT 1022783798838,,-400.0,,17463.2,,0.0,Personal
576,20221011000000[-6:CST]*-200.00*0**XX3498 ATM WITHDRAWAL. 405 5TH ST AMES I A IA000614 009318,10/11/2022,XX3498 ATM WITHDRAWAL. 405 5TH ST AMES I A IA000614 009318,,-200.0,,17863.2,,0.0,Personal
577,20221011000000[-6:CST]*-56.00*0**XX3498 POS WITHDRAWAL. WHEATSFIELD COOP AMES IA 68087201 585706,10/11/2022,XX3498 POS WITHDRAWAL. WHEATSFIELD COOP AMES IA 68087201 585706,,-56.0,,18063.2,,0.0,Groceries
578,20221011000000[-6:CST]*-52.57*0**XX3498 POS PURCHASE AT PERFECT GAMES AME S IA 03638228 562624,10/11/2022,XX3498 POS PURCHASE AT PERFECT GAMES AME S IA 03638228 562624,,-52.57,,18119.2,,0.0,Entertainment
579,20221011000000[-6:CST]*-49.73*0**XX3498 POS WITHDRAWAL. Wal-Mart Super C AMES IA 07490050 228406742136,10/11/2022,XX3498 POS WITHDRAWAL. Wal-Mart Super C AMES IA 07490050 228406742136,,-49.73,,18171.77,,0.0,Groceries
580,20221011000000[-6:CST]*-15.38*0**XX3498 POS PURCHASE AT SQ *LOCKWOOD AMES IA 71210103 820951,10/11/2022,XX3498 POS PURCHASE AT SQ *LOCKWOOD AMES IA 71210103 820951,,-15.38,,18221.5,,0.0,Food & Drink
581,20221011000000[-6:CST]*1000.00*501**00034395 TRANSFER FROM 460484 ON 10/10/2 2 AT 11:11,10/11/2022,00034395 TRANSFER FROM 460484 ON 10/10/2 2 AT 11:11,,,1000.0,18236.88,,0.0,Deposit
582,20221007000000[-6:CST]*-37.20*0**XX3498 POS PURCHASE AT XBK DES MOINES IA 05392221 474831,10/07/2022,XX3498 POS PURCHASE AT XBK DES MOINES IA 05392221 474831,,-37.2,,17236.88,,0.0,Entertainment
583,20221007000000[-6:CST]*-17.02*0**XX3498 POS WITHDRAWAL. KUMGO 0731 DES D ES MOINES IA 001 724930,10/07/2022,XX3498 POS WITHDRAWAL. KUM&GO 0731 DES D ES MOINES IA 001 724930,,-17.02,,17274.08,,0.0,Gas
584,20221007000000[-6:CST]*-16.07*0**XX3498 POS PURCHASE AT TST* DOUGH CO. P DES MOINES IA 75498443 811030,10/07/2022,XX3498 POS PURCHASE AT TST* DOUGH CO. P DES MOINES IA 75498443 811030,,-16.07,,17291.1,,0.0,Food & Drink
585,20221007000000[-6:CST]*-15.00*0**XX3498 POS PURCHASE AT XBK DES MOINES IA 05391876 042912,10/07/2022,XX3498 POS PURCHASE AT XBK DES MOINES IA 05391876 042912,,-15.0,,17307.17,,0.0,Entertainment
586,20221006000000[-6:CST]*-6067.54*0**CHASE CREDIT CRD AUTOPAY 000000000163202,10/06/2022,CHASE CREDIT CRD AUTOPAY 000000000163202,,-6067.54,,17322.17,,0.0,Bills & Utilities
587,20221006000000[-6:CST]*-98.56*0**VENMO PAYMENT 1022737188124,10/06/2022,VENMO PAYMENT 1022737188124,,-98.56,,23389.71,,0.0,Personal
588,20221005000000[-6:CST]*-712.75*0**IOWA BANKERS MTG ACH PMT XXXXXX2430,10/05/2022,IOWA BANKERS MTG ACH PMT XXXXXX2430,,-712.75,,23488.27,,0.0,Home
589,20221005000000[-6:CST]*-47.95*0**XX3498 POS WITHDRAWAL. Wal-Mart Super C AMES IA 07490050 227811112564,10/05/2022,XX3498 POS WITHDRAWAL. Wal-Mart Super C AMES IA 07490050 227811112564,,-47.95,,24201.02,,0.0,Groceries
590,20221003000000[-6:CST]*-220.00*0**VENMO PAYMENT 1022669262111,10/03/2022,VENMO PAYMENT 1022669262111,,-220.0,,24248.97,,0.0,Personal
591,20221003000000[-6:CST]*-200.00*0**XX3498 ATM WITHDRAWAL. 405 5TH ST AMES I A IA000614 008768,10/03/2022,XX3498 ATM WITHDRAWAL. 405 5TH ST AMES I A IA000614 008768,,-200.0,,24468.97,,0.0,Personal
592,20221003000000[-6:CST]*-29.00*0**XX3498 POS PURCHASE AT O DONNELL ACE HA AMES IA 75002303 443218,10/03/2022,XX3498 POS PURCHASE AT O DONNELL ACE HA AMES IA 75002303 443218,,-29.0,,24668.97,,0.0,Home
593,20221003000000[-6:CST]*-25.00*0**XX3498 POS PURCHASE AT SQ *ACPS Ames IA 04299704 663188,10/03/2022,XX3498 POS PURCHASE AT SQ *ACPS Ames IA 04299704 663188,,-25.0,,24697.97,,0.0,Entertainment
594,20221003000000[-6:CST]*-15.00*0**XX3498 POS PURCHASE AT O DONNELL ACE HA AMES IA 75001016 637257,10/03/2022,XX3498 POS PURCHASE AT O DONNELL ACE HA AMES IA 75001016 637257,,-15.0,,24722.97,,0.0,Home
595,20221003000000[-6:CST]*-12.42*0**XX3498 POS PURCHASE AT SQ *CORNBRED BAR Ames IA 04084160 428694,10/03/2022,XX3498 POS PURCHASE AT SQ *CORNBRED BAR Ames IA 04084160 428694,,-12.42,,24737.97,,0.0,Food & Drink
596,20220930000000[-6:CST]*-1549.25*0**COUNTY TREASURER TAX 3639772,09/30/2022,COUNTY TREASURER TAX 3639772,,-1549.25,,24750.39,,0.0,Home
597,20220930000000[-6:CST]*3639.11*501**DONNELLEY FINANC DIRECT DEP 925024472981 L5Z,09/30/2022,DONNELLEY FINANC DIRECT DEP 925024472981 L5Z,,,3639.11,26299.64,,0.0,Deposit
598,20220929000000[-6:CST]*-2302.00*0**DHS CSRU IOW DHS IOWDHS011889009,09/29/2022,DHS CSRU IOW DHS IOWDHS011889009,,-2302.0,,22660.53,,0.0,Bills & Utilities
599,20220929000000[-6:CST]*-0.29*0**DHS CSRU conv fee IOWDHS011889010,09/29/2022,DHS CSRU conv fee IOWDHS011889010,,-0.29,,24962.53,,0.0,Bills & Utilities
600,20220929000000[-6:CST]*-90.19*0**XX3498 POS WITHDRAWAL. Wal-Mart Super C AMES IA 07490046 227229000247,09/29/2022,XX3498 POS WITHDRAWAL. Wal-Mart Super C AMES IA 07490046 227229000247,,-90.19,,24962.82,,0.0,Groceries
601,20220929000000[-6:CST]*-76.00*0**XX3498 POS WITHDRAWAL. WHEATSFIELD COOP AMES IA 68087201 546716,09/29/2022,XX3498 POS WITHDRAWAL. WHEATSFIELD COOP AMES IA 68087201 546716,,-76.0,,25053.01,,0.0,Groceries
602,20220928000000[-6:CST]*-125.71*0**CITY OF AMES UT BILL 002629810006826,09/28/2022,CITY OF AMES UT BILL 002629810006826,,-125.71,,25129.01,,0.0,Bills & Utilities
603,20220928000000[-6:CST]*-42.91*0**XX3498 POS PURCHASE AT PERFECT GAMES AME S IA 04022133 308563,09/28/2022,XX3498 POS PURCHASE AT PERFECT GAMES AME S IA 04022133 308563,,-42.91,,25254.72,,0.0,Entertainment
604,20220928000000[-6:CST]*-18.66*0**XX3498 POS PURCHASE AT LOTF_1 AMES IA 04 420915 130270,09/28/2022,XX3498 POS PURCHASE AT LOTF_1 AMES IA 04 420915 130270,,-18.66,,25297.63,,0.0,Food & Drink
605,20220928000000[-6:CST]*-7.22*0**XX3498 POS PURCHASE AT LOTF_1 AMES IA 04 420923 712546,09/28/2022,XX3498 POS PURCHASE AT LOTF_1 AMES IA 04 420923 712546,,-7.22,,25316.29,,0.0,Food & Drink
606,20220927000000[-6:CST]*-153.49*0**CITY OF AMES UT BILL 002819790003022,09/27/2022,CITY OF AMES UT BILL 002819790003022,,-153.49,,25323.51,,0.0,Bills & Utilities
607,20220926000000[-6:CST]*-120.00*0**XX3498 ATM WITHDRAWAL. 119 MAIN ST AMES IA RT35199 009240,09/26/2022,XX3498 ATM WITHDRAWAL. 119 MAIN ST AMES IA RT35199 009240,,-120.0,,25477.0,,0.0,Personal
608,20220926000000[-6:CST]*-25.00*0**XX3498 POS PURCHASE AT SQ *ACPS Ames IA 89931729 261593,09/26/2022,XX3498 POS PURCHASE AT SQ *ACPS Ames IA 89931729 261593,,-25.0,,25597.0,,0.0,Entertainment
609,20220926000000[-6:CST]*-21.00*0**XX3498 POS PURCHASE AT O DONNELL ACE HA AMES IA 76001302 912045,09/26/2022,XX3498 POS PURCHASE AT O DONNELL ACE HA AMES IA 76001302 912045,,-21.0,,25622.0,,0.0,Home
610,20220926000000[-6:CST]*-10.57*0**XX3498 POS PURCHASE AT B BOPS AMES NORT AMES IA 21965550 430238,09/26/2022,XX3498 POS PURCHASE AT B BOPS AMES NORT AMES IA 21965550 430238,,-10.57,,25643.0,,0.0,Food & Drink
611,20220926000000[-6:CST]*-10.57*0**XX3498 POS WITHDRAWAL. CASEYS #2905 AMES IA 600001 037543,09/26/2022,XX3498 POS WITHDRAWAL. CASEYS #2905 AMES IA 600001 037543,,-10.57,,25653.57,,0.0,Gas
612,20220926000000[-6:CST]*-3.49*0**ATM WITHDRAWAL FEE XX3498 ATM WITHDRAWAL . 119 MAIN ST AMES IA RT35199 009240,09/26/2022,ATM WITHDRAWAL FEE XX3498 ATM WITHDRAWAL . 119 MAIN ST AMES IA RT35199 009240,,-3.49,,25664.14,,0.0,Personal
613,20220923000000[-6:CST]*-631.01*0**FARMERS INS EFT PYMT mXXXXX5868,09/23/2022,FARMERS INS EFT PYMT mXXXXX5868,,-631.01,,25667.63,,0.0,Automotive
614,20220923000000[-6:CST]*-71.94*0**XX3498 POS WITHDRAWAL. HY VEE 1013 AMES IA 1 779696,09/23/2022,XX3498 POS WITHDRAWAL. HY VEE 1013 AMES IA 1 779696,,-71.94,,26298.64,,0.0,Groceries
615,20220923000000[-6:CST]*-40.75*0**XX3498 POS PURCHASE AT EL CHARRO BAR AN TOLEDO IA 02783787 424154,09/23/2022,XX3498 POS PURCHASE AT EL CHARRO BAR AN TOLEDO IA 02783787 424154,,-40.75,,26370.58,,0.0,Food & Drink
616,20220923000000[-6:CST]*-19.44*0**XX3498 POS PURCHASE AT SQ *CORNBRED BAR Ames IA 85969294 781253,09/23/2022,XX3498 POS PURCHASE AT SQ *CORNBRED BAR Ames IA 85969294 781253,,-19.44,,26411.33,,0.0,Food & Drink
617,20220922000000[-6:CST]*-22.87*0**XX3498 POS WITHDRAWAL. WAL-MART #749 AME S IA 600001 064125,09/22/2022,XX3498 POS WITHDRAWAL. WAL-MART #749 AME S IA 600001 064125,,-22.87,,26430.77,,0.0,Groceries
618,20220921000000[-6:CST]*-21.42*0**Alliant - IPL PAYMENT 0061467186,09/21/2022,Alliant - IPL PAYMENT 0061467186,,-21.42,,26453.64,,0.0,Bills & Utilities
619,20220921000000[-6:CST]*-36.80*0**XX3498 POS PURCHASE AT MCGRATH AMPHITHE CEDAR RAPIDS IA 48567302 511096,09/21/2022,XX3498 POS PURCHASE AT MCGRATH AMPHITHE CEDAR RAPIDS IA 48567302 511096,,-36.8,,26475.06,,0.0,Travel
620,20220921000000[-6:CST]*-6.74*0**XX3498 POS WITHDRAWAL. CAFE SAINT PIO CEDAR RAPIDS IA 05286431 2264380007,09/21/2022,XX3498 POS WITHDRAWAL. CAFE SAINT PIO CEDAR RAPIDS IA 05286431 2264380007,,-6.74,,26511.86,,0.0,Travel
621,20220920000000[-6:CST]*-55.86*0**XX3498 POS WITHDRAWAL. HY VEE 1018 AMES IA 001 275776,09/20/2022,XX3498 POS WITHDRAWAL. HY VEE 1018 AMES IA 001 275776,,-55.86,,26518.6,,0.0,Groceries
622,20220919000000[-6:CST]*-35.00*0**VENMO PAYMENT 1022405213126,09/19/2022,VENMO PAYMENT 1022405213126,,-35.0,,26574.46,,0.0,Personal
623,20220919000000[-6:CST]*-24.60*0**CLUB FEES PLANET FIT 515-620-8880,09/19/2022,CLUB FEES PLANET FIT 515-620-8880,,-24.6,,26609.46,,0.0,Personal
624,20220919000000[-6:CST]*-105.00*0**XX3498 POS PURCHASE AT SQ *ACPS Ames IA 82893747 255927,09/19/2022,XX3498 POS PURCHASE AT SQ *ACPS Ames IA 82893747 255927,,-105.0,,26634.06,,0.0,Entertainment
625,20220919000000[-6:CST]*-100.00*0**XX3498 ATM WITHDRAWAL. 405 5TH ST AMES I A IA000614 007973,09/19/2022,XX3498 ATM WITHDRAWAL. 405 5TH ST AMES I A IA000614 007973,,-100.0,,26739.06,,0.0,Personal
626,20220919000000[-6:CST]*-12.00*0**XX3498 POS PURCHASE AT GOODWILL AMES AME S IA 99700161 232390,09/19/2022,XX3498 POS PURCHASE AT GOODWILL AMES AME S IA 99700161 232390,,-12.0,,26839.06,,0.0,Home
627,20220916000000[-6:CST]*-27.80*0**XX3498 POS PURCHASE AT KWIK STOP LIQUOR AMES IA 68173749 065740,09/16/2022,XX3498 POS PURCHASE AT KWIK STOP LIQUOR AMES IA 68173749 065740,,-27.8,,26851.06,,0.0,Food & Drink
628,20220916000000[-6:CST]*-27.00*0**XX3498 POS WITHDRAWAL. WHEATSFIELD COOP AMES IA 68087201 337997,09/16/2022,XX3498 POS WITHDRAWAL. WHEATSFIELD COOP AMES IA 68087201 337997,,-27.0,,26878.86,,0.0,Groceries
629,20220916000000[-6:CST]*-25.00*0**XX3498 POS PURCHASE AT SQ *LONDON UNDER Ames IA 29549272 308460,09/16/2022,XX3498 POS PURCHASE AT SQ *LONDON UNDER Ames IA 29549272 308460,,-25.0,,26905.86,,0.0,Food & Drink
630,20220916000000[-6:CST]*-20.00*0**XX3498 POS WITHDRAWAL. HY VEE CLINIC 30 AMES IA 001 864537,09/16/2022,XX3498 POS WITHDRAWAL. HY VEE CLINIC 30 AMES IA 001 864537,,-20.0,,26930.86,,0.0,Groceries
631,20220916000000[-6:CST]*-12.67*0**XX3498 POS WITHDRAWAL. FAREWAY STORES # AMES IA 92405701 824000,09/16/2022,XX3498 POS WITHDRAWAL. FAREWAY STORES # AMES IA 92405701 824000,,-12.67,,26950.86,,0.0,Groceries
632,20220916000000[-6:CST]*-7.69*0**XX3498 POS WITHDRAWAL. MCDONALD'S M2021 AMES IA 81545310 369079,09/16/2022,XX3498 POS WITHDRAWAL. MCDONALD'S M2021 AMES IA 81545310 369079,,-7.69,,26963.53,,0.0,Food & Drink
633,20220916000000[-6:CST]*3639.10*501**DONNELLEY FINANC DIRECT DEP 721065311027 L5Z,09/16/2022,DONNELLEY FINANC DIRECT DEP 721065311027 L5Z,,,3639.1,26971.22,,0.0,Deposit
634,20220915000000[-6:CST]*-100.00*0**XX3498 ATM WITHDRAWAL. 212 MAIN ST AMES IA RT35204 003178,09/15/2022,XX3498 ATM WITHDRAWAL. 212 MAIN ST AMES IA RT35204 003178,,-100.0,,23332.12,,0.0,Personal
635,20220915000000[-6:CST]*-5.97*0**XX3498 POS WITHDRAWAL. SWIFT STOP 5 AMES IA 00354J26 225879520121,09/15/2022,XX3498 POS WITHDRAWAL. SWIFT STOP 5 AMES IA 00354J26 225879520121,,-5.97,,23432.12,,0.0,Gas
636,20220915000000[-6:CST]*-3.49*0**ATM WITHDRAWAL FEE XX3498 ATM WITHDRAWAL . 212 MAIN ST AMES IA RT35204 003178,09/15/2022,ATM WITHDRAWAL FEE XX3498 ATM WITHDRAWAL . 212 MAIN ST AMES IA RT35204 003178,,-3.49,,23438.09,,0.0,Personal
637,20220914000000[-6:CST]*-240.70*0**VERIZON WIRELESS PAYMENTS 05885909720000 1,09/14/2022,VERIZON WIRELESS PAYMENTS 05885909720000 1,,-240.7,,23441.58,,0.0,Bills & Utilities
638,20220914000000[-6:CST]*-21.48*0**Alliant - IPL PAYMENT 3836938783,09/14/2022,Alliant - IPL PAYMENT 3836938783,,-21.48,,23682.28,,0.0,Bills & Utilities
639,20220914000000[-6:CST]*-74.00*0**XX3498 POS WITHDRAWAL. WHEATSFIELD COOP AMES IA 68087201 025635,09/14/2022,XX3498 POS WITHDRAWAL. WHEATSFIELD COOP AMES IA 68087201 025635,,-74.0,,23703.76,,0.0,Groceries
640,20220913000000[-6:CST]*1.88*501**Interest paid,09/13/2022,Interest paid,,,1.88,23777.76,,0.0,Deposit
641,20220912000000[-6:CST]*-83.91*0**XX3498 POS WITHDRAWAL. WAL-MART #0749 AM ES IA 24074901 462229,09/12/2022,XX3498 POS WITHDRAWAL. WAL-MART #0749 AM ES IA 24074901 462229,,-83.91,,23775.88,,0.0,Groceries
642,20220912000000[-6:CST]*-22.74*0**XX3498 POS WITHDRAWAL. CASEYS #2301 AMES IA 600001 020462,09/12/2022,XX3498 POS WITHDRAWAL. CASEYS #2301 AMES IA 600001 020462,,-22.74,,23859.79,,0.0,Gas
643,20220912000000[-6:CST]*-5.78*0**XX3498 POS WITHDRAWAL. CASEYS #2905 AMES IA 600001 034681,09/12/2022,XX3498 POS WITHDRAWAL. CASEYS #2905 AMES IA 600001 034681,,-5.78,,23882.53,,0.0,Gas
644,20220909000000[-6:CST]*-36.66*0**XX3498 POS WITHDRAWAL. CASEYS #2301 AMES IA 600001 054097,09/09/2022,XX3498 POS WITHDRAWAL. CASEYS #2301 AMES IA 600001 054097,,-36.66,,23888.31,,0.0,Gas
645,20220909000000[-6:CST]*-20.30*0**XX3498 POS PURCHASE AT SQ *ALLUVIAL BRE Ames IA 41066709 210714,09/09/2022,XX3498 POS PURCHASE AT SQ *ALLUVIAL BRE Ames IA 41066709 210714,,-20.3,,23924.97,,0.0,Food & Drink
646,20220909000000[-6:CST]*-19.00*0**XX3498 POS PURCHASE AT O DONNELL ACE HA AMES IA 71001926 565163,09/09/2022,XX3498 POS PURCHASE AT O DONNELL ACE HA AMES IA 71001926 565163,,-19.0,,23945.27,,0.0,Home
647,20220906000000[-6:CST]*-1773.42*0**CHASE CREDIT CRD AUTOPAY 000000000160023,09/06/2022,CHASE CREDIT CRD AUTOPAY 000000000160023,,-1773.42,,23964.27,,0.0,Bills & Utilities
648,20220906000000[-6:CST]*-712.75*0**IOWA BANKERS MTG ACH PMT XXXXXX2430,09/06/2022,IOWA BANKERS MTG ACH PMT XXXXXX2430,,-712.75,,25737.69,,0.0,Home
649,20220906000000[-6:CST]*-200.00*0**XX3498 ATM WITHDRAWAL. 405 5TH ST AMES I A IA000619 002339,09/06/2022,XX3498 ATM WITHDRAWAL. 405 5TH ST AMES I A IA000619 002339,,-200.0,,26450.44,,0.0,Personal
650,20220906000000[-6:CST]*-52.98*0**XX3498 POS PURCHASE AT PHILLIPS 66 - SW AMES IA 22052272 425381,09/06/2022,XX3498 POS PURCHASE AT PHILLIPS 66 - SW AMES IA 22052272 425381,,-52.98,,26650.44,,0.0,Gas
651,20220906000000[-6:CST]*-35.02*0**XX3498 POS WITHDRAWAL. WAL-MART #749 AME S IA 600001 016708,09/06/2022,XX3498 POS WITHDRAWAL. WAL-MART #749 AME S IA 600001 016708,,-35.02,,26703.42,,0.0,Groceries
652,20220906000000[-6:CST]*-29.36*0**XX3498 POS WITHDRAWAL. FAREWAY STORES # AMES IA 92405501 035400,09/06/2022,XX3498 POS WITHDRAWAL. FAREWAY STORES # AMES IA 92405501 035400,,-29.36,,26738.44,,0.0,Groceries
653,20220906000000[-6:CST]*-28.00*0**XX3498 POS PURCHASE AT O DONNELL ACE HA AMES IA 75001522 255623,09/06/2022,XX3498 POS PURCHASE AT O DONNELL ACE HA AMES IA 75001522 255623,,-28.0,,26767.8,,0.0,Home
654,20220906000000[-6:CST]*-25.00*0**XX3498 POS PURCHASE AT SQ *ACPS Ames IA 39362201 649396,09/06/2022,XX3498 POS PURCHASE AT SQ *ACPS Ames IA 39362201 649396,,-25.0,,26795.8,,0.0,Entertainment
655,20220906000000[-6:CST]*-23.00*0**XX3498 POS PURCHASE AT GOODWILL AMES AME S IA 99700095 932918,09/06/2022,XX3498 POS PURCHASE AT GOODWILL AMES AME S IA 99700095 932918,,-23.0,,26820.8,,0.0,Home
656,20220906000000[-6:CST]*-20.52*0**XX3498 POS PURCHASE AT SQ *CORNBRED BAR Ames IA 30897442 629515,09/06/2022,XX3498 POS PURCHASE AT SQ *CORNBRED BAR Ames IA 30897442 629515,,-20.52,,26843.8,,0.0,Food & Drink
657,20220906000000[-6:CST]*-10.29*0**XX3498 POS WITHDRAWAL. WAL-MART #749 AME S IA 600001 039143,09/06/2022,XX3498 POS WITHDRAWAL. WAL-MART #749 AME S IA 600001 039143,,-10.29,,26864.32,,0.0,Groceries
658,20220902000000[-6:CST]*-200.00*0**VENMO PAYMENT 1022101244724,09/02/2022,VENMO PAYMENT 1022101244724,,-200.0,,26874.61,,0.0,Personal
659,20220902000000[-6:CST]*-27.00*0**XX3498 POS PURCHASE AT SQ *ALLUVIAL BRE Ames IA 01108312 892898,09/02/2022,XX3498 POS PURCHASE AT SQ *ALLUVIAL BRE Ames IA 01108312 892898,,-27.0,,27074.61,,0.0,Food & Drink
660,20220902000000[-6:CST]*-21.22*0**XX3498 POS WITHDRAWAL. HY VEE 1013 AMES IA 1 031053,09/02/2022,XX3498 POS WITHDRAWAL. HY VEE 1013 AMES IA 1 031053,,-21.22,,27101.61,,0.0,Groceries
661,20220902000000[-6:CST]*3639.10*501**DONNELLEY FINANC DIRECT DEP 797085575815 L5Z,09/02/2022,DONNELLEY FINANC DIRECT DEP 797085575815 L5Z,,,3639.1,27122.83,,0.0,Deposit
662,20220901000000[-6:CST]*-35.00*0**VENMO PAYMENT 1022085719802,09/01/2022,VENMO PAYMENT 1022085719802,,-35.0,,23483.73,,0.0,Personal
663,20220901000000[-6:CST]*-43.00*0**XX3498 POS PURCHASE AT O DONNELL ACE HA AMES IA 76000734 510579,09/01/2022,XX3498 POS PURCHASE AT O DONNELL ACE HA AMES IA 76000734 510579,,-43.0,,23518.73,,0.0,Home
664,20220831000000[-6:CST]*-2302.00*0**DHS CSRU IOW DHS IOWDHS011794476,08/31/2022,DHS CSRU IOW DHS IOWDHS011794476,,-2302.0,,23561.73,,0.0,Bills & Utilities
665,20220831000000[-6:CST]*-0.29*0**DHS CSRU conv fee IOWDHS011794477,08/31/2022,DHS CSRU conv fee IOWDHS011794477,,-0.29,,25863.73,,0.0,Bills & Utilities
666,20220831000000[-6:CST]*-108.00*0**XX3498 POS WITHDRAWAL. WHEATSFIELD COOP AMES IA 68087201 635490,08/31/2022,XX3498 POS WITHDRAWAL. WHEATSFIELD COOP AMES IA 68087201 635490,,-108.0,,25864.02,,0.0,Groceries
667,20220831000000[-6:CST]*-32.64*0**XX3498 POS PURCHASE AT SQ *CORNBRED BAR Ames IA 37926040 806208,08/31/2022,XX3498 POS PURCHASE AT SQ *CORNBRED BAR Ames IA 37926040 806208,,-32.64,,25972.02,,0.0,Food & Drink
668,20220831000000[-6:CST]*-10.00*0**XX3498 POS PURCHASE AT SQ *LONDON UNDER Ames IA 71679235 586678,08/31/2022,XX3498 POS PURCHASE AT SQ *LONDON UNDER Ames IA 71679235 586678,,-10.0,,26004.66,,0.0,Food & Drink
669,20220830000000[-6:CST]*-200.00*0**XX3498 ATM WITHDRAWAL. 405 5TH ST AMES I A IA000619 002241,08/30/2022,XX3498 ATM WITHDRAWAL. 405 5TH ST AMES I A IA000619 002241,,-200.0,,26014.66,,0.0,Personal
670,20220829000000[-6:CST]*-72.92*0**XX3498 POS WITHDRAWAL. Epic Spirits New York NY 00716873 152727,08/29/2022,XX3498 POS WITHDRAWAL. Epic Spirits New York NY 00716873 152727,,-72.92,,26214.66,,0.0,Travel
671,20220829000000[-6:CST]*-55.46*0**XX3498 POS PURCHASE AT SANDBAR-MARQUIS NEW YORK NY 47833265 965237,08/29/2022,XX3498 POS PURCHASE AT SANDBAR-MARQUIS NEW YORK NY 47833265 965237,,-55.46,,26287.58,,0.0,Travel
672,20220829000000[-6:CST]*-31.00*0**XX3498 POS PURCHASE AT NY PENN STA 50 NEW YORK NY 80737217 889091,08/29/2022,XX3498 POS PURCHASE AT NY PENN STA 50 NEW YORK NY 80737217 889091,,-31.0,,26343.04,,0.0,Travel
673,20220829000000[-6:CST]*-10.38*0**XX3498 POS PURCHASE AT HEALTHY CHOICE G NEW YORK NY 17701068 335315,08/29/2022,XX3498 POS PURCHASE AT HEALTHY CHOICE G NEW YORK NY 17701068 335315,,-10.38,,26374.04,,0.0,Travel
674,20220829000000[-6:CST]*-9.53*0**XX3498 POS PURCHASE AT SQ *THE BEAN New York NY 19276286 402296,08/29/2022,XX3498 POS PURCHASE AT SQ *THE BEAN New York NY 19276286 402296,,-9.53,,26384.42,,0.0,Food & Drink
675,20220829000000[-6:CST]*-6.53*0**XX3498 POS PURCHASE AT SQ *STUMPTOWN CO New York NY 11096352 614147,08/29/2022,XX3498 POS PURCHASE AT SQ *STUMPTOWN CO New York NY 11096352 614147,,-6.53,,26393.95,,0.0,Food & Drink
676,20220829000000[-6:CST]*-5.88*0**XX3498 POS PURCHASE AT SQ *BAGEL PUB CH New York NY 58554939 231565,08/29/2022,XX3498 POS PURCHASE AT SQ *BAGEL PUB CH New York NY 58554939 231565,,-5.88,,26400.48,,0.0,Food & Drink
677,20220829000000[-6:CST]*-4.58*0**XX3498 POS WITHDRAWAL. KUMGO 0131 HUXL HUXLEY IA 001 786703,08/29/2022,XX3498 POS WITHDRAWAL. KUM&GO 0131 HUXL HUXLEY IA 001 786703,,-4.58,,26406.36,,0.0,Gas
678,20220826000000[-6:CST]*-136.92*0**CITY OF AMES UT BILL 002629810006826,08/26/2022,CITY OF AMES UT BILL 002629810006826,,-136.92,,26410.94,,0.0,Bills & Utilities
679,20220826000000[-6:CST]*-16.00*0**XX3498 POS PURCHASE AT MSG CONCESSIONS NEW YORK NY 89633402 617145,08/26/2022,XX3498 POS PURCHASE AT MSG CONCESSIONS NEW YORK NY 89633402 617145,,-16.0,,26547.86,,0.0,Travel
680,20220826000000[-6:CST]*-13.00*0**XX3498 POS WITHDRAWAL. WHOLEFDS 95 E H NEW YORK NY 74681002 130397,08/26/2022,XX3498 POS WITHDRAWAL. WHOLEFDS 95 E H NEW YORK NY 74681002 130397,,-13.0,,26563.86,,0.0,Travel
681,20220826000000[-6:CST]*-11.50*0**XX3498 POS PURCHASE AT SQ *THE PICKLE G New York NY 83502275 100207,08/26/2022,XX3498 POS PURCHASE AT SQ *THE PICKLE G New York NY 83502275 100207,,-11.5,,26576.86,,0.0,Food & Drink
682,20220826000000[-6:CST]*-6.98*0**XX3498 POS PURCHASE AT BRAVO PIZZA NEW YORK NY 16602502 834707,08/26/2022,XX3498 POS PURCHASE AT BRAVO PIZZA NEW YORK NY 16602502 834707,,-6.98,,26588.36,,0.0,Travel
683,20220825000000[-6:CST]*-11.97*0**XX3498 POS PURCHASE AT TST* Caffe Lodi NEW YORK NY 66449537 633473,08/25/2022,XX3498 POS PURCHASE AT TST* Caffe Lodi NEW YORK NY 66449537 633473,,-11.97,,26595.34,,0.0,Travel
684,20220825000000[-6:CST]*-3.49*0**XX3498 POS PURCHASE AT TST* PARIS BAGUE NEW YORK NY 97196283 111580,08/25/2022,XX3498 POS PURCHASE AT TST* PARIS BAGUE NEW YORK NY 97196283 111580,,-3.49,,26607.31,,0.0,Travel
685,20220824000000[-6:CST]*-146.20*0**CITY OF AMES UT BILL 002819790003022,08/24/2022,CITY OF AMES UT BILL 002819790003022,,-146.2,,26610.8,,0.0,Bills & Utilities
686,20220824000000[-6:CST]*-20.03*0**XX3498 POS PURCHASE AT SQ *SEED + MILL NEW YORK NY 56203320 866391,08/24/2022,XX3498 POS PURCHASE AT SQ *SEED + MILL NEW YORK NY 56203320 866391,,-20.03,,26757.0,,0.0,Food & Drink
687,20220824000000[-6:CST]*-17.20*0**XX3498 POS PURCHASE AT TST* Ess-a-Bagel New York NY 51100358 925033,08/24/2022,XX3498 POS PURCHASE AT TST* Ess-a-Bagel New York NY 51100358 925033,,-17.2,,26777.03,,0.0,Travel
688,20220824000000[-6:CST]*-15.87*0**XX3498 POS WITHDRAWAL. TRADER JOE'S # NEW YORK NY 69454311 078120,08/24/2022,XX3498 POS WITHDRAWAL. TRADER JOE'S # NEW YORK NY 69454311 078120,,-15.87,,26794.23,,0.0,Groceries
689,20220824000000[-6:CST]*-13.28*0**XX3498 POS WITHDRAWAL. WHOLEFDS 250 7T NEW YORK NY 99583001 060846,08/24/2022,XX3498 POS WITHDRAWAL. WHOLEFDS 250 7T NEW YORK NY 99583001 060846,,-13.28,,26810.1,,0.0,Travel
690,20220824000000[-6:CST]*-10.51*0**XX3498 POS PURCHASE AT FRESH 2 GO MARKE NEW YORK NY 19988063 018163,08/24/2022,XX3498 POS PURCHASE AT FRESH 2 GO MARKE NEW YORK NY 19988063 018163,,-10.51,,26823.38,,0.0,Travel
691,20220824000000[-6:CST]*-9.23*0**XX3498 POS WITHDRAWAL. FAIRWAY MARKET O NEW YORK NY 001 223616913685,08/24/2022,XX3498 POS WITHDRAWAL. FAIRWAY MARKET O NEW YORK NY 001 223616913685,,-9.23,,26833.89,,0.0,Travel
692,20220824000000[-6:CST]*-5.99*0**XX3498 POS WITHDRAWAL. WESTSIDE MARKET- NEW YORK NY 50010601 566448,08/24/2022,XX3498 POS WITHDRAWAL. WESTSIDE MARKET- NEW YORK NY 50010601 566448,,-5.99,,26843.12,,0.0,Travel
693,20220823000000[-6:CST]*-758.00*0**FARMERS INS EFT PYMT mXXXXX5868,08/23/2022,FARMERS INS EFT PYMT mXXXXX5868,,-758.0,,26849.11,,0.0,Automotive
694,20220823000000[-6:CST]*-34.00*0**XX3498 POS PURCHASE AT MTA*METROCARD MA NEW YORK NY 15664183 433780,08/23/2022,XX3498 POS PURCHASE AT MTA*METROCARD MA NEW YORK NY 15664183 433780,,-34.0,,27607.11,,0.0,Travel
695,20220823000000[-6:CST]*-12.00*0**XX3498 POS PURCHASE AT MTA*METROCARD MA NEW YORK NY 15664688 032416,08/23/2022,XX3498 POS PURCHASE AT MTA*METROCARD MA NEW YORK NY 15664688 032416,,-12.0,,27641.11,,0.0,Travel
696,20220822000000[-6:CST]*-35.00*0**VENMO PAYMENT 1021906314052,08/22/2022,VENMO PAYMENT 1021906314052,,-35.0,,27653.11,,0.0,Personal
697,20220822000000[-6:CST]*-34.37*0**XX3498 POS WITHDRAWAL. TRADER JOE'S # NEW YORK NY 69454322 441213,08/22/2022,XX3498 POS WITHDRAWAL. TRADER JOE'S # NEW YORK NY 69454322 441213,,-34.37,,27688.11,,0.0,Groceries
698,20220822000000[-6:CST]*-33.50*0**XX3498 POS PURCHASE AT SQ *CORNBRED BAR Ames IA 91416057 700533,08/22/2022,XX3498 POS PURCHASE AT SQ *CORNBRED BAR Ames IA 91416057 700533,,-33.5,,27722.48,,0.0,Food & Drink
699,20220822000000[-6:CST]*-25.00*0**XX3498 POS PURCHASE AT SQ *ACPS Ames IA 85719592 753969,08/22/2022,XX3498 POS PURCHASE AT SQ *ACPS Ames IA 85719592 753969,,-25.0,,27755.98,,0.0,Entertainment
700,20220822000000[-6:CST]*-12.30*0**XX3498 POS PURCHASE AT ABERLARDOSMEXICA AMES IA 10305858 016984,08/22/2022,XX3498 POS PURCHASE AT ABERLARDOSMEXICA AMES IA 10305858 016984,,-12.3,,27780.98,,0.0,Food & Drink
701,20220819000000[-6:CST]*-16.91*0**Alliant - IPL PAYMENT 0061467186,08/19/2022,Alliant - IPL PAYMENT 0061467186,,-16.91,,27793.28,,0.0,Bills & Utilities
702,20220819000000[-6:CST]*-42.36*0**XX3498 POS WITHDRAWAL. FAREWAY STORES # AMES IA 92405701 095900,08/19/2022,XX3498 POS WITHDRAWAL. FAREWAY STORES # AMES IA 92405701 095900,,-42.36,,27810.19,,0.0,Groceries
703,20220819000000[-6:CST]*-26.59*0**XX3498 POS WITHDRAWAL. HY VEE CLINIC 30 AMES IA 001 068787,08/19/2022,XX3498 POS WITHDRAWAL. HY VEE CLINIC 30 AMES IA 001 068787,,-26.59,,27852.55,,0.0,Groceries
704,20220819000000[-6:CST]*-400.00*0**Miscellaneous Debit,08/19/2022,Miscellaneous Debit,,-400.0,,27879.14,,0.0,Personal
705,20220819000000[-6:CST]*3639.11*501**DONNELLEY FINANC DIRECT DEP 933024318641 L5Z,08/19/2022,DONNELLEY FINANC DIRECT DEP 933024318641 L5Z,,,3639.11,28279.14,,0.0,Deposit
706,20220818000000[-6:CST]*-25.65*0**XX3498 POS WITHDRAWAL. WALGREENS 2719 G AMES IA 12108T21 013374,08/18/2022,XX3498 POS WITHDRAWAL. WALGREENS 2719 G AMES IA 12108T21 013374,,-25.65,,24640.03,,0.0,Groceries
707,20220817000000[-6:CST]*-24.60*0**CLUB FEES PLANET FIT 515-620-8880,08/17/2022,CLUB FEES PLANET FIT 515-620-8880,,-24.6,,24665.68,,0.0,Personal
708,20220817000000[-6:CST]*-13.28*0**XX3498 POS WITHDRAWAL. WALGREENS 2719 G AMES IA 12108T21 142654,08/17/2022,XX3498 POS WITHDRAWAL. WALGREENS 2719 G AMES IA 12108T21 142654,,-13.28,,24690.28,,0.0,Groceries
709,20220816000000[-6:CST]*-14150.00*1*1041*Check,08/16/2022,Check,,-14150.0,,24703.56,1041.0,0.0,Personal
710,20220816000000[-6:CST]*-240.70*0**VERIZON WIRELESS PAYMENTS 05885909720000 1,08/16/2022,VERIZON WIRELESS PAYMENTS 05885909720000 1,,-240.7,,38853.56,,0.0,Bills & Utilities
711,20220816000000[-6:CST]*-52.00*0**XX3498 POS WITHDRAWAL. WHEATSFIELD COOP AMES IA 68087201 176311,08/16/2022,XX3498 POS WITHDRAWAL. WHEATSFIELD COOP AMES IA 68087201 176311,,-52.0,,39094.26,,0.0,Groceries
712,20220815000000[-6:CST]*-535.00*1*1040*Check,08/15/2022,Check,,-535.0,,39146.26,1040.0,0.0,Personal
713,20220815000000[-6:CST]*-58.82*0**XX3498 POS PURCHASE AT SQ *BLUE FISH HA Ames IA 91926158 096374,08/15/2022,XX3498 POS PURCHASE AT SQ *BLUE FISH HA Ames IA 91926158 096374,,-58.82,,39681.26,,0.0,Food & Drink
714,20220815000000[-6:CST]*-25.00*0**XX3498 POS PURCHASE AT SQ *ACPS Ames IA 24284303 315936,08/15/2022,XX3498 POS PURCHASE AT SQ *ACPS Ames IA 24284303 315936,,-25.0,,39740.08,,0.0,Entertainment
715,20220815000000[-6:CST]*-15.26*0**XX3498 POS WITHDRAWAL. KUMGO 1113 AMES AMES IA 001 628928,08/15/2022,XX3498 POS WITHDRAWAL. KUM&GO 1113 AMES AMES IA 001 628928,,-15.26,,39765.08,,0.0,Gas
716,20220812000000[-6:CST]*-20.51*0**Alliant - IPL PAYMENT 3836938783,08/12/2022,Alliant - IPL PAYMENT 3836938783,,-20.51,,39780.34,,0.0,Bills & Utilities
717,20220812000000[-6:CST]*-33.00*0**XX3498 POS WITHDRAWAL. WHEATSFIELD COOP AMES IA 68087201 295630,08/12/2022,XX3498 POS WITHDRAWAL. WHEATSFIELD COOP AMES IA 68087201 295630,,-33.0,,39800.85,,0.0,Groceries
718,20220812000000[-6:CST]*-17.16*0**XX3498 POS WITHDRAWAL. WALGREENS 2719 G AMES IA 12108T22 022372,08/12/2022,XX3498 POS WITHDRAWAL. WALGREENS 2719 G AMES IA 12108T22 022372,,-17.16,,39833.85,,0.0,Groceries
719,20220812000000[-6:CST]*-10.69*0**XX3498 POS PURCHASE AT T J MAXX #1279 AM ES IA 02869705 908060,08/12/2022,XX3498 POS PURCHASE AT T J MAXX #1279 AM ES IA 02869705 908060,,-10.69,,39851.01,,0.0,Shopping
720,20220810000000[-6:CST]*-50.36*0**XX3498 POS WITHDRAWAL. WHEATSFIELD COOP AMES IA 68087201 847303,08/10/2022,XX3498 POS WITHDRAWAL. WHEATSFIELD COOP AMES IA 68087201 847303,,-50.36,,39861.7,,0.0,Groceries
721,20220810000000[-6:CST]*-28.75*0**XX3498 POS WITHDRAWAL. Wal-Mart Super C AMES IA 07490044 222252510242,08/10/2022,XX3498 POS WITHDRAWAL. Wal-Mart Super C AMES IA 07490044 222252510242,,-28.75,,39912.06,,0.0,Groceries
722,20220810000000[-6:CST]*-11.00*0**XX3498 POS WITHDRAWAL. MCDONALD'S M2021 AMES IA 81545305 310235,08/10/2022,XX3498 POS WITHDRAWAL. MCDONALD'S M2021 AMES IA 81545305 310235,,-11.0,,39940.81,,0.0,Food & Drink
723,20220809000000[-6:CST]*1.94*501**Interest paid,08/09/2022,Interest paid,,,1.94,39951.81,,0.0,Deposit
724,20220809000000[-6:CST]*-35.78*0**XX3498 POS PURCHASE AT PERFECT GAMES AME S IA 44063004 166585,08/09/2022,XX3498 POS PURCHASE AT PERFECT GAMES AME S IA 44063004 166585,,-35.78,,39949.87,,0.0,Entertainment
725,20220809000000[-6:CST]*-6.63*0**XX3498 POS WITHDRAWAL. ALDI 72048 AMES I A 88741003 077906,08/09/2022,XX3498 POS WITHDRAWAL. ALDI 72048 AMES I A 88741003 077906,,-6.63,,39985.65,,0.0,Groceries
726,20220808000000[-6:CST]*-4518.03*0**CHASE CREDIT CRD AUTOPAY 000000000288767,08/08/2022,CHASE CREDIT CRD AUTOPAY 000000000288767,,-4518.03,,39992.28,,0.0,Bills & Utilities
727,20220808000000[-6:CST]*-47.58*0**XX3498 POS PURCHASE AT O DONNELL ACE HA AMES IA 73001934 398429,08/08/2022,XX3498 POS PURCHASE AT O DONNELL ACE HA AMES IA 73001934 398429,,-47.58,,44510.31,,0.0,Home
728,20220808000000[-6:CST]*-44.42*0**XX3498 POS PURCHASE AT SQ *CORNBRED BAR Ames IA 00730610 271760,08/08/2022,XX3498 POS PURCHASE AT SQ *CORNBRED BAR Ames IA 00730610 271760,,-44.42,,44557.89,,0.0,Food & Drink
729,20220808000000[-6:CST]*-38.00*0**XX3498 POS WITHDRAWAL. WHEATSFIELD COOP AMES IA 68087201 623320,08/08/2022,XX3498 POS WITHDRAWAL. WHEATSFIELD COOP AMES IA 68087201 623320,,-38.0,,44602.31,,0.0,Groceries
730,20220808000000[-6:CST]*-26.00*0**XX3498 POS PURCHASE AT O DONNELL ACE HA AMES IA 73001660 021586,08/08/2022,XX3498 POS PURCHASE AT O DONNELL ACE HA AMES IA 73001660 021586,,-26.0,,44640.31,,0.0,Home
731,20220808000000[-6:CST]*-25.00*0**XX3498 POS PURCHASE AT SQ *ACPS Ames IA 68564646 017681,08/08/2022,XX3498 POS PURCHASE AT SQ *ACPS Ames IA 68564646 017681,,-25.0,,44666.31,,0.0,Entertainment
732,20220805000000[-6:CST]*-712.75*0**IOWA BANKERS MTG ACH PMT XXXXXX2430,08/05/2022,IOWA BANKERS MTG ACH PMT XXXXXX2430,,-712.75,,44691.31,,0.0,Home
733,20220805000000[-6:CST]*-34.69*0**XX3498 POS WITHDRAWAL. WHEATSFIELD COOP AMES IA 68087201 232884,08/05/2022,XX3498 POS WITHDRAWAL. WHEATSFIELD COOP AMES IA 68087201 232884,,-34.69,,45404.06,,0.0,Groceries
734,20220805000000[-6:CST]*-25.00*0**XX3498 POS PURCHASE AT SQ *CORNBRED BAR Ames IA 25543031 868778,08/05/2022,XX3498 POS PURCHASE AT SQ *CORNBRED BAR Ames IA 25543031 868778,,-25.0,,45438.75,,0.0,Food & Drink
735,20220805000000[-6:CST]*-25.00*0**XX3498 POS PURCHASE AT O DONNELL ACE HA AMES IA 70002101 554769,08/05/2022,XX3498 POS PURCHASE AT O DONNELL ACE HA AMES IA 70002101 554769,,-25.0,,45463.75,,0.0,Home
736,20220805000000[-6:CST]*-14.65*0**XX3498 POS WITHDRAWAL. HY VEE 1018 AMES IA 001 179464,08/05/2022,XX3498 POS WITHDRAWAL. HY VEE 1018 AMES IA 001 179464,,-14.65,,45488.75,,0.0,Groceries
737,20220805000000[-6:CST]*3639.10*501**DONNELLEY FINANC DIRECT DEP 615080852281 L5Z,08/05/2022,DONNELLEY FINANC DIRECT DEP 615080852281 L5Z,,,3639.1,45503.4,,0.0,Deposit
738,20220804000000[-6:CST]*-42.79*0**XX3498 POS WITHDRAWAL. HY VEE 1018 AMES IA 001 673590,08/04/2022,XX3498 POS WITHDRAWAL. HY VEE 1018 AMES IA 001 673590,,-42.79,,41864.3,,0.0,Groceries
739,20220804000000[-6:CST]*-18.00*0**XX3498 POS PURCHASE AT THE SALVATION AR AMES IA 60626866 038916,08/04/2022,XX3498 POS PURCHASE AT THE SALVATION AR AMES IA 60626866 038916,,-18.0,,41907.09,,0.0,Home
740,20220803000000[-6:CST]*-200.00*0**XX3498 ATM WITHDRAWAL. 405 5TH ST AMES I A IA000614 004906,08/03/2022,XX3498 ATM WITHDRAWAL. 405 5TH ST AMES I A IA000614 004906,,-200.0,,41925.09,,0.0,Personal
741,20220803000000[-6:CST]*-300.00*0**Miscellaneous Debit,08/03/2022,Miscellaneous Debit,,-300.0,,42125.09,,0.0,Personal
742,20220802000000[-6:CST]*-82.00*0**XX3498 POS WITHDRAWAL. WHEATSFIELD COOP AMES IA 68087201 622534,08/02/2022,XX3498 POS WITHDRAWAL. WHEATSFIELD COOP AMES IA 68087201 622534,,-82.0,,42425.09,,0.0,Groceries
743,20220802000000[-6:CST]*-11.10*0**XX3498 POS PURCHASE AT THE CAFE AMES IA 06303357 431251,08/02/2022,XX3498 POS PURCHASE AT THE CAFE AMES IA 06303357 431251,,-11.1,,42507.09,,0.0,Food & Drink
744,20220802000000[-6:CST]*-9.19*0**XX3498 POS PURCHASE AT B BOPS AMES NORT AMES IA 30576682 093113,08/02/2022,XX3498 POS PURCHASE AT B BOPS AMES NORT AMES IA 30576682 093113,,-9.19,,42518.19,,0.0,Food & Drink
745,20220801000000[-6:CST]*-68.54*0**XX3498 POS PURCHASE AT PHILLIPS 66 - SW AMES IA 22233951 333645,08/01/2022,XX3498 POS PURCHASE AT PHILLIPS 66 - SW AMES IA 22233951 333645,,-68.54,,42527.38,,0.0,Gas
746,20220801000000[-6:CST]*-25.00*0**XX3498 POS PURCHASE AT SQ *ACPS Ames IA 82040003 453370,08/01/2022,XX3498 POS PURCHASE AT SQ *ACPS Ames IA 82040003 453370,,-25.0,,42595.92,,0.0,Entertainment
747,20220801000000[-6:CST]*-13.51*0**XX3498 POS PURCHASE AT PHO  TEA CAFE L AMES IA 12000555 359955,08/01/2022,XX3498 POS PURCHASE AT PHO & TEA CAFE L AMES IA 12000555 359955,,-13.51,,42620.92,,0.0,Food & Drink
748,20220801000000[-6:CST]*-6.45*0**XX3498 POS WITHDRAWAL. SWIFT STOP 5 AMES IA 00354J26 221172601713,08/01/2022,XX3498 POS WITHDRAWAL. SWIFT STOP 5 AMES IA 00354J26 221172601713,,-6.45,,42634.43,,0.0,Gas
749,20220801000000[-6:CST]*-3.48*0**XX3498 POS WITHDRAWAL. WAL-MART #749 AME S IA 600001 052079,08/01/2022,XX3498 POS WITHDRAWAL. WAL-MART #749 AME S IA 600001 052079,,-3.48,,42640.88,,0.0,Groceries
750,20220729000000[-6:CST]*-60.94*0**XX3498 POS PURCHASE AT SQ *CORNBRED BAR Ames IA 39381949 246629,07/29/2022,XX3498 POS PURCHASE AT SQ *CORNBRED BAR Ames IA 39381949 246629,,-60.94,,42644.36,,0.0,Food & Drink
751,20220728000000[-6:CST]*-2302.00*0**DHS CSRU IOW DHS IOWDHS011678235,07/28/2022,DHS CSRU IOW DHS IOWDHS011678235,,-2302.0,,42705.3,,0.0,Bills & Utilities
752,20220728000000[-6:CST]*-104.99*0**CITY OF AMES UT BILL 002629810006826,07/28/2022,CITY OF AMES UT BILL 002629810006826,,-104.99,,45007.3,,0.0,Bills & Utilities
753,20220728000000[-6:CST]*-0.29*0**DHS CSRU conv fee IOWDHS011678236,07/28/2022,DHS CSRU conv fee IOWDHS011678236,,-0.29,,45112.29,,0.0,Bills & Utilities
754,20220728000000[-6:CST]*-29.40*0**XX3498 POS PURCHASE AT KWIK STOP LIQUOR AMES IA 41036953 903574,07/28/2022,XX3498 POS PURCHASE AT KWIK STOP LIQUOR AMES IA 41036953 903574,,-29.4,,45112.58,,0.0,Food & Drink
755,20220728000000[-6:CST]*18744.67*501**PAYMENT Farmers Insuran 1633650979 Fire Insurance Exchange,07/28/2022,PAYMENT Farmers Insuran 1633650979 Fire Insurance Exchange,,,18744.67,45141.98,,0.0,Deposit
756,20220727000000[-6:CST]*-5335.00*1*1039*Check,07/27/2022,Check,,-5335.0,,26397.31,1039.0,0.0,Personal
757,20220727000000[-6:CST]*-145.21*0**CITY OF AMES UT BILL 002819790003022,07/27/2022,CITY OF AMES UT BILL 002819790003022,,-145.21,,31732.31,,0.0,Bills & Utilities
758,20220727000000[-6:CST]*-45.00*0**VENMO PAYMENT 1021441042297,07/27/2022,VENMO PAYMENT 1021441042297,,-45.0,,31877.52,,0.0,Personal
759,20220727000000[-6:CST]*-200.00*0**XX3498 ATM WITHDRAWAL. 405 5TH ST AMES I A IA000619 001590,07/27/2022,XX3498 ATM WITHDRAWAL. 405 5TH ST AMES I A IA000619 001590,,-200.0,,31922.52,,0.0,Personal
760,20220727000000[-6:CST]*-53.17*0**XX3498 POS PURCHASE AT SQ *CORNBRED BAR AMES IA 74864230 507177,07/27/2022,XX3498 POS PURCHASE AT SQ *CORNBRED BAR AMES IA 74864230 507177,,-53.17,,32122.52,,0.0,Food & Drink
761,20220727000000[-6:CST]*-32.00*0**XX3498 POS WITHDRAWAL. WHEATSFIELD COOP AMES IA 68087201 968507,07/27/2022,XX3498 POS WITHDRAWAL. WHEATSFIELD COOP AMES IA 68087201 968507,,-32.0,,32175.69,,0.0,Groceries
762,20220727000000[-6:CST]*-12.06*0**XX3498 POS PURCHASE AT QT 559 DES MOINES IA 01674779 661302,07/27/2022,XX3498 POS PURCHASE AT QT 559 DES MOINES IA 01674779 661302,,-12.06,,32207.69,,0.0,Gas
763,20220726000000[-6:CST]*-23.41*0**XX3498 POS PURCHASE AT PERFECT GAMES AME S IA 57079123 530029,07/26/2022,XX3498 POS PURCHASE AT PERFECT GAMES AME S IA 57079123 530029,,-23.41,,32219.75,,0.0,Entertainment
764,20220726000000[-6:CST]*-1.00*0**XX3498 POS PURCHASE AT DES MOINES AIRPO DES MOINES IA 64348897 469143,07/26/2022,XX3498 POS PURCHASE AT DES MOINES AIRPO DES MOINES IA 64348897 469143,,-1.0,,32243.16,,0.0,Travel
765,20220725000000[-6:CST]*-425.35*0**FARMERS INS EFT PYMT mXXXXX5868,07/25/2022,FARMERS INS EFT PYMT mXXXXX5868,,-425.35,,32244.16,,0.0,Automotive
766,20220725000000[-6:CST]*-60.00*0**VENMO PAYMENT 1021384123637,07/25/2022,VENMO PAYMENT 1021384123637,,-60.0,,32669.51,,0.0,Personal
767,20220725000000[-6:CST]*-37.24*0**XX3498 POS PURCHASE AT SQ *CORNBRED BAR AMES IA 55338305 162729,07/25/2022,XX3498 POS PURCHASE AT SQ *CORNBRED BAR AMES IA 55338305 162729,,-37.24,,32729.51,,0.0,Food & Drink
768,20220725000000[-6:CST]*-33.03*0**XX3498 POS PURCHASE AT BLAZE PIZZA AMES AMES IA 75711786 800893,07/25/2022,XX3498 POS PURCHASE AT BLAZE PIZZA AMES AMES IA 75711786 800893,,-33.03,,32766.75,,0.0,Food & Drink
769,20220725000000[-6:CST]*-30.23*0**XX3498 POS PURCHASE AT CINEMARK THEATRE AMES IA 88190752 939358,07/25/2022,XX3498 POS PURCHASE AT CINEMARK THEATRE AMES IA 88190752 939358,,-30.23,,32799.78,,0.0,Entertainment
770,20220725000000[-6:CST]*-29.12*0**XX3498 POS PURCHASE AT NORTH GRAND SEAF AMES IA 00111526 563350,07/25/2022,XX3498 POS PURCHASE AT NORTH GRAND SEAF AMES IA 00111526 563350,,-29.12,,32830.01,,0.0,Entertainment
771,20220725000000[-6:CST]*-26.76*0**XX3498 POS PURCHASE AT CINEMARK THEATRE AMES IA 88190224 043148,07/25/2022,XX3498 POS PURCHASE AT CINEMARK THEATRE AMES IA 88190224 043148,,-26.76,,32859.13,,0.0,Entertainment
772,20220725000000[-6:CST]*-25.00*0**XX3498 POS PURCHASE AT SQ *ACPS Ames IA 35377875 245852,07/25/2022,XX3498 POS PURCHASE AT SQ *ACPS Ames IA 35377875 245852,,-25.0,,32885.89,,0.0,Entertainment
773,20220725000000[-6:CST]*-21.00*0**XX3498 POS PURCHASE AT GOODWILL AMES AME S IA 99700137 094275,07/25/2022,XX3498 POS PURCHASE AT GOODWILL AMES AME S IA 99700137 094275,,-21.0,,32910.89,,0.0,Home
774,20220725000000[-6:CST]*-20.00*0**XX3498 POS PURCHASE AT SQ *LONDON UNDER Ames IA 54059214 488961,07/25/2022,XX3498 POS PURCHASE AT SQ *LONDON UNDER Ames IA 54059214 488961,,-20.0,,32931.89,,0.0,Food & Drink
775,20220725000000[-6:CST]*-13.78*0**XX3498 POS WITHDRAWAL. CASEYS #2298 AMES IA 600001 003829,07/25/2022,XX3498 POS WITHDRAWAL. CASEYS #2298 AMES IA 600001 003829,,-13.78,,32951.89,,0.0,Gas
776,20220725000000[-6:CST]*-6.28*0**XX3498 POS PURCHASE AT SQ *LOCKWOOD AMES IA 34064789 164253,07/25/2022,XX3498 POS PURCHASE AT SQ *LOCKWOOD AMES IA 34064789 164253,,-6.28,,32965.67,,0.0,Food & Drink
777,20220722000000[-6:CST]*-200.00*0**XX3498 ATM WITHDRAWAL. 405 5TH ST AMES I A IA000614 004166,07/22/2022,XX3498 ATM WITHDRAWAL. 405 5TH ST AMES I A IA000614 004166,,-200.0,,32971.95,,0.0,Personal
778,20220722000000[-6:CST]*-125.00*0**XX3498 POS WITHDRAWAL. WHEATSFIELD COOP AMES IA 68087201 648122,07/22/2022,XX3498 POS WITHDRAWAL. WHEATSFIELD COOP AMES IA 68087201 648122,,-125.0,,33171.95,,0.0,Groceries
779,20220722000000[-6:CST]*-26.00*0**XX3498 POS PURCHASE AT SPORTSMANS LOUNG Ames IA 20819584 583538,07/22/2022,XX3498 POS PURCHASE AT SPORTSMANS LOUNG Ames IA 20819584 583538,,-26.0,,33296.95,,0.0,Food & Drink
780,20220722000000[-6:CST]*3639.10*501**DONNELLEY FINANC DIRECT DEP 938922275181 L5Z,07/22/2022,DONNELLEY FINANC DIRECT DEP 938922275181 L5Z,,,3639.1,33322.95,,0.0,Deposit
781,20220721000000[-6:CST]*-27.36*0**Alliant - IPL PAYMENT 0061467186,07/21/2022,Alliant - IPL PAYMENT 0061467186,,-27.36,,29683.85,,0.0,Bills & Utilities
782,20220720000000[-6:CST]*-65.48*0**XX3498 POS PURCHASE AT SQ *CORNBRED BAR Ames IA 49618926 503584,07/20/2022,XX3498 POS PURCHASE AT SQ *CORNBRED BAR Ames IA 49618926 503584,,-65.48,,29711.21,,0.0,Food & Drink
783,20220719000000[-6:CST]*-105.00*0**XX3498 POS WITHDRAWAL. WHEATSFIELD COOP AMES IA 68087201 181750,07/19/2022,XX3498 POS WITHDRAWAL. WHEATSFIELD COOP AMES IA 68087201 181750,,-105.0,,29776.69,,0.0,Groceries
784,20220719000000[-6:CST]*-39.04*0**XX3498 POS WITHDRAWAL. WAL-MART #0749 AM ES IA 24074901 720632,07/19/2022,XX3498 POS WITHDRAWAL. WAL-MART #0749 AM ES IA 24074901 720632,,-39.04,,29881.69,,0.0,Groceries
785,20220719000000[-6:CST]*-36.00*0**XX3498 POS PURCHASE AT O DONNELL ACE HA AMES IA 74000688 708585,07/19/2022,XX3498 POS PURCHASE AT O DONNELL ACE HA AMES IA 74000688 708585,,-36.0,,29920.73,,0.0,Home
786,20220719000000[-6:CST]*-30.50*0**XX3498 POS PURCHASE AT PERFECT GAMES AME S IA 41206885 225021,07/19/2022,XX3498 POS PURCHASE AT PERFECT GAMES AME S IA 41206885 225021,,-30.5,,29956.73,,0.0,Entertainment
787,20220718000000[-6:CST]*-45.00*0**VENMO PAYMENT 1021276848970,07/18/2022,VENMO PAYMENT 1021276848970,,-45.0,,29987.23,,0.0,Personal
788,20220718000000[-6:CST]*-24.60*0**CLUB FEES PLANET FIT 515-620-8880,07/18/2022,CLUB FEES PLANET FIT 515-620-8880,,-24.6,,30032.23,,0.0,Personal
789,20220718000000[-6:CST]*-40.29*0**XX3498 POS WITHDRAWAL. HY VEE 1018 AMES IA 001 416938,07/18/2022,XX3498 POS WITHDRAWAL. HY VEE 1018 AMES IA 001 416938,,-40.29,,30056.83,,0.0,Groceries
790,20220718000000[-6:CST]*-21.44*0**XX3498 POS WITHDRAWAL. HY VEE 1018 AMES IA 1 767411,07/18/2022,XX3498 POS WITHDRAWAL. HY VEE 1018 AMES IA 1 767411,,-21.44,,30097.12,,0.0,Groceries
791,20220718000000[-6:CST]*-3.48*0**XX3498 POS WITHDRAWAL. Wal-Mart Super C AMES IA 07490047 219983352851,07/18/2022,XX3498 POS WITHDRAWAL. Wal-Mart Super C AMES IA 07490047 219983352851,,-3.48,,30118.56,,0.0,Groceries
792,20220715000000[-6:CST]*-24.24*0**XX3498 POS PURCHASE AT STEAK-N-SHAKE#02 CHAMPAIGN IL 27213743 324835,07/15/2022,XX3498 POS PURCHASE AT STEAK-N-SHAKE#02 CHAMPAIGN IL 27213743 324835,,-24.24,,30122.04,,0.0,Travel
793,20220715000000[-6:CST]*1573.91*501**DONNELLEY FINANC DIRECT-PAY 16016904,07/15/2022,DONNELLEY FINANC DIRECT-PAY 16016904,,,1573.91,30146.28,,0.0,Deposit
794,20220715000000[-6:CST]*349.55*501**DONNELLEY FINANC DIRECT-PAY 16016918,07/15/2022,DONNELLEY FINANC DIRECT-PAY 16016918,,,349.55,28572.37,,0.0,Deposit
795,20220714000000[-6:CST]*-239.68*0**VERIZON WIRELESS PAYMENTS 05885909720000 1,07/14/2022,VERIZON WIRELESS PAYMENTS 05885909720000 1,,-239.68,,28222.82,,0.0,Bills & Utilities
796,20220714000000[-6:CST]*-35.10*0**Alliant - IPL PAYMENT 3836938783,07/14/2022,Alliant - IPL PAYMENT 3836938783,,-35.1,,28462.5,,0.0,Bills & Utilities
797,20220714000000[-6:CST]*-18.01*0**XX3498 POS PURCHASE AT ARK ENCOUNTER WIL LIAMSTOWN KY 17072063 801181,07/14/2022,XX3498 POS PURCHASE AT ARK ENCOUNTER WIL LIAMSTOWN KY 17072063 801181,,-18.01,,28497.6,,0.0,Travel
798,20220714000000[-6:CST]*-3.17*0**XX3498 POS PURCHASE AT SQ *SMOKE HOUSE W illiamstown KY 87702419 703462,07/14/2022,XX3498 POS PURCHASE AT SQ *SMOKE HOUSE W illiamstown KY 87702419 703462,,-3.17,,28515.61,,0.0,Food & Drink
799,20220714000000[-6:CST]*-2.43*0**XX3498 POS PURCHASE AT ARK ENCOUNTER WIL LIAMSTOWN KY 13006271 427597,07/14/2022,XX3498 POS PURCHASE AT ARK ENCOUNTER WIL LIAMSTOWN KY 13006271 427597,,-2.43,,28518.78,,0.0,Travel
800,20220713000000[-6:CST]*-11.23*0**XX3498 POS PURCHASE AT SBARRO CORALVILL CORALVILLE IA 00209477 376173,07/13/2022,XX3498 POS PURCHASE AT SBARRO CORALVILL CORALVILLE IA 00209477 376173,,-11.23,,28521.21,,0.0,Food & Drink
801,20220713000000[-6:CST]*-10.60*0**XX3498 POS PURCHASE AT SQ *UNCLE LEROY P etersburg KY 76989591 322527,07/13/2022,XX3498 POS PURCHASE AT SQ *UNCLE LEROY P etersburg KY 76989591 322527,,-10.6,,28532.44,,0.0,Food & Drink
802,20220712000000[-6:CST]*1.78*501**Interest paid,07/12/2022,Interest paid,,,1.78,28543.04,,0.0,Deposit
803,20220712000000[-6:CST]*-77.55*0**ASPEN WASTE SYST EFT PMT 8 00257691,07/12/2022,ASPEN WASTE SYST EFT PMT 8 00257691,,-77.55,,28541.26,,0.0,Bills & Utilities
804,20220712000000[-6:CST]*-10.99*0**XX3498 POS PURCHASE AT SARKU JAPAN 192 C ORALVILLE IA 05962793 459706,07/12/2022,XX3498 POS PURCHASE AT SARKU JAPAN 192 C ORALVILLE IA 05962793 459706,,-10.99,,28618.81,,0.0,Food & Drink
805,20220711000000[-6:CST]*-35.00*0**VENMO PAYMENT 1021151150458,07/11/2022,VENMO PAYMENT 1021151150458,,-35.0,,28629.8,,0.0,Personal
806,20220711000000[-6:CST]*-200.00*0**XX3498 ATM WITHDRAWAL. 405 5TH ST AMES I A IA000614 003346,07/11/2022,XX3498 ATM WITHDRAWAL. 405 5TH ST AMES I A IA000614 003346,,-200.0,,28664.8,,0.0,Personal
807,20220711000000[-6:CST]*-128.00*0**XX3498 POS WITHDRAWAL. WHEATSFIELD COOP AMES IA 68087201 556262,07/11/2022,XX3498 POS WITHDRAWAL. WHEATSFIELD COOP AMES IA 68087201 556262,,-128.0,,28864.8,,0.0,Groceries
808,20220711000000[-6:CST]*-39.96*0**XX3498 POS PURCHASE AT SQ *CORNBRED BAR Ames IA 65364509 960323,07/11/2022,XX3498 POS PURCHASE AT SQ *CORNBRED BAR Ames IA 65364509 960323,,-39.96,,28992.8,,0.0,Food & Drink
809,20220711000000[-6:CST]*-36.00*0**XX3498 POS PURCHASE AT 80/35 Music Fest Des Moines IA 10250809 643178,07/11/2022,XX3498 POS PURCHASE AT 80/35 Music Fest Des Moines IA 10250809 643178,,-36.0,,29032.76,,0.0,Entertainment
810,20220711000000[-6:CST]*-18.00*0**XX3498 POS PURCHASE AT 80/35 Music Fest Des Moines IA 00006617 343182,07/11/2022,XX3498 POS PURCHASE AT 80/35 Music Fest Des Moines IA 00006617 343182,,-18.0,,29068.76,,0.0,Entertainment
811,20220711000000[-6:CST]*-16.70*0**XX3498 POS WITHDRAWAL. SOUTH GATE EXPRE AMES IA 002V6J88 366560,07/11/2022,XX3498 POS WITHDRAWAL. SOUTH GATE EXPRE AMES IA 002V6J88 366560,,-16.7,,29086.76,,0.0,Gas
812,20220711000000[-6:CST]*-13.46*0**XX3498 POS PURCHASE AT KWIK STOP LIQUOR AMES IA 76202991 372262,07/11/2022,XX3498 POS PURCHASE AT KWIK STOP LIQUOR AMES IA 76202991 372262,,-13.46,,29103.46,,0.0,Food & Drink
813,20220711000000[-6:CST]*-9.51*0**XX3498 POS PURCHASE AT B BOPS AMES NORT AMES IA 78712989 242210,07/11/2022,XX3498 POS PURCHASE AT B BOPS AMES NORT AMES IA 78712989 242210,,-9.51,,29116.92,,0.0,Food & Drink
814,20220708000000[-6:CST]*-40.00*0**VENMO PAYMENT 1021098825253,07/08/2022,VENMO PAYMENT 1021098825253,,-40.0,,29126.43,,0.0,Personal
815,20220708000000[-6:CST]*3639.12*501**DONNELLEY FINANC DIRECT DEP 385084979849 L5Z,07/08/2022,DONNELLEY FINANC DIRECT DEP 385084979849 L5Z,,,3639.12,29166.43,,0.0,Deposit
816,20220707000000[-6:CST]*-55.74*0**XX3498 POS PURCHASE AT PERFECT GAMES AME S IA 37771970 237539,07/07/2022,XX3498 POS PURCHASE AT PERFECT GAMES AME S IA 37771970 237539,,-55.74,,25527.31,,0.0,Entertainment
817,20220707000000[-6:CST]*-28.65*0**XX3498 POS WITHDRAWAL. WALGREENS 2719 G AMES IA 12108T21 036688,07/07/2022,XX3498 POS WITHDRAWAL. WALGREENS 2719 G AMES IA 12108T21 036688,,-28.65,,25583.05,,0.0,Groceries
818,20220707000000[-6:CST]*-22.45*0**XX3498 POS PURCHASE AT PHO  TEA CAFE L AMES IA 12000513 775709,07/07/2022,XX3498 POS PURCHASE AT PHO & TEA CAFE L AMES IA 12000513 775709,,-22.45,,25611.7,,0.0,Food & Drink
819,20220707000000[-6:CST]*-6.42*0**XX3498 POS PURCHASE AT PERFECT GAMES AME S IA 37772143 016377,07/07/2022,XX3498 POS PURCHASE AT PERFECT GAMES AME S IA 37772143 016377,,-6.42,,25634.15,,0.0,Entertainment
820,20220706000000[-6:CST]*-1912.14*0**CHASE CREDIT CRD AUTOPAY 000000000155994,07/06/2022,CHASE CREDIT CRD AUTOPAY 000000000155994,,-1912.14,,25640.57,,0.0,Bills & Utilities
821,20220705000000[-6:CST]*-712.75*0**IOWA BANKERS MTG ACH PMT XXXXXX2430,07/05/2022,IOWA BANKERS MTG ACH PMT XXXXXX2430,,-712.75,,27552.71,,0.0,Home
822,20220705000000[-6:CST]*-79.79*0**XX3498 POS WITHDRAWAL. CYCLONE L 626 LI AMES IA 94367101 146951,07/05/2022,XX3498 POS WITHDRAWAL. CYCLONE L 626 LI AMES IA 94367101 146951,,-79.79,,28265.46,,0.0,Food & Drink
823,20220705000000[-6:CST]*-50.19*0**XX3498 POS WITHDRAWAL. ALDI 72048 AMES I A 88741003 370934,07/05/2022,XX3498 POS WITHDRAWAL. ALDI 72048 AMES I A 88741003 370934,,-50.19,,28345.25,,0.0,Groceries
824,20220705000000[-6:CST]*-47.51*0**XX3498 POS WITHDRAWAL. WAL-MART #749 AME S IA 600001 058758,07/05/2022,XX3498 POS WITHDRAWAL. WAL-MART #749 AME S IA 600001 058758,,-47.51,,28395.44,,0.0,Groceries
825,20220705000000[-6:CST]*-36.78*0**XX3498 POS PURCHASE AT SQ *CORNBRED BAR Ames IA 49044859 450135,07/05/2022,XX3498 POS PURCHASE AT SQ *CORNBRED BAR Ames IA 49044859 450135,,-36.78,,28442.95,,0.0,Food & Drink
826,20220705000000[-6:CST]*-14.96*0**XX3498 POS PURCHASE AT THE SALVATION AR AMES IA 40367469 989058,07/05/2022,XX3498 POS PURCHASE AT THE SALVATION AR AMES IA 40367469 989058,,-14.96,,28479.73,,0.0,Home
827,20220705000000[-6:CST]*-14.74*0**XX3498 POS PURCHASE AT VILLAGE INN 7002 AMES IA 42445738 735091,07/05/2022,XX3498 POS PURCHASE AT VILLAGE INN 7002 AMES IA 42445738 735091,,-14.74,,28494.69,,0.0,Food & Drink
828,20220705000000[-6:CST]*-5.98*0**XX3498 POS WITHDRAWAL. WALGREENS 2719 G AMES IA 12108T21 217191,07/05/2022,XX3498 POS WITHDRAWAL. WALGREENS 2719 G AMES IA 12108T21 217191,,-5.98,,28509.43,,0.0,Groceries
829,20220705000000[-6:CST]*-4.76*0**XX3498 POS PURCHASE AT STARBUCKS STORE A MES IA 17421021 164440,07/05/2022,XX3498 POS PURCHASE AT STARBUCKS STORE A MES IA 17421021 164440,,-4.76,,28515.41,,0.0,Food & Drink
830,20220630000000[-6:CST]*-200.00*0**XX3498 ATM WITHDRAWAL. 405 5TH ST AMES I A IA000614 002739,06/30/2022,XX3498 ATM WITHDRAWAL. 405 5TH ST AMES I A IA000614 002739,,-200.0,,28520.17,,0.0,Personal
831,20220630000000[-6:CST]*-40.00*0**XX3498 ATM WITHDRAWAL. 119 MAIN ST AMES IA RT35199 009008,06/30/2022,XX3498 ATM WITHDRAWAL. 119 MAIN ST AMES IA RT35199 009008,,-40.0,,28720.17,,0.0,Personal
832,20220630000000[-6:CST]*-21.77*0**XX3498 POS PURCHASE AT SQ *CORNBRED BAR AMES IA 37473846 151773,06/30/2022,XX3498 POS PURCHASE AT SQ *CORNBRED BAR AMES IA 37473846 151773,,-21.77,,28760.17,,0.0,Food & Drink
833,20220630000000[-6:CST]*-3.49*0**ATM WITHDRAWAL FEE XX3498 ATM WITHDRAWAL . 119 MAIN ST AMES IA RT35199 009008,06/30/2022,ATM WITHDRAWAL FEE XX3498 ATM WITHDRAWAL . 119 MAIN ST AMES IA RT35199 009008,,-3.49,,28781.94,,0.0,Personal
834,20220629000000[-6:CST]*-32.05*0**XX3498 POS PURCHASE AT SQ *CORNBRED BAR AMES IA 07282304 818231,06/29/2022,XX3498 POS PURCHASE AT SQ *CORNBRED BAR AMES IA 07282304 818231,,-32.05,,28785.43,,0.0,Food & Drink
835,20220629000000[-6:CST]*-9.83*0**XX3498 POS PURCHASE AT CULVERS OF AMES A MES IA 00176823 548469,06/29/2022,XX3498 POS PURCHASE AT CULVERS OF AMES A MES IA 00176823 548469,,-9.83,,28817.48,,0.0,Food & Drink
836,20220628000000[-6:CST]*-2302.00*0**DHS CSRU IOW DHS IOWDHS011560454,06/28/2022,DHS CSRU IOW DHS IOWDHS011560454,,-2302.0,,28827.31,,0.0,Bills & Utilities
837,20220628000000[-6:CST]*-104.66*0**CITY OF AMES UT BILL 002629810006826,06/28/2022,CITY OF AMES UT BILL 002629810006826,,-104.66,,31129.31,,0.0,Bills & Utilities
838,20220628000000[-6:CST]*-0.29*0**DHS CSRU conv fee IOWDHS011560455,06/28/2022,DHS CSRU conv fee IOWDHS011560455,,-0.29,,31233.97,,0.0,Bills & Utilities
839,20220628000000[-6:CST]*-35.41*0**XX3498 POS PURCHASE AT PERFECT GAMES AME S IA 30070755 554896,06/28/2022,XX3498 POS PURCHASE AT PERFECT GAMES AME S IA 30070755 554896,,-35.41,,31234.26,,0.0,Entertainment
840,20220627000000[-6:CST]*-200.00*0**XX3498 ATM WITHDRAWAL. 405 5TH ST AMES I A IA000619 000922,06/27/2022,XX3498 ATM WITHDRAWAL. 405 5TH ST AMES I A IA000619 000922,,-200.0,,31269.67,,0.0,Personal
841,20220627000000[-6:CST]*-80.00*0**XX3498 POS WITHDRAWAL. WHEATSFIELD COOP AMES IA 68087201 219405,06/27/2022,XX3498 POS WITHDRAWAL. WHEATSFIELD COOP AMES IA 68087201 219405,,-80.0,,31469.67,,0.0,Groceries
842,20220627000000[-6:CST]*-79.20*0**XX3498 POS PURCHASE AT LOTF_1 AMES IA 10 085921 952480,06/27/2022,XX3498 POS PURCHASE AT LOTF_1 AMES IA 10 085921 952480,,-79.2,,31549.67,,0.0,Food & Drink
843,20220627000000[-6:CST]*-62.00*0**XX3498 POS WITHDRAWAL. WHEATSFIELD COOP AMES IA 68087201 245045,06/27/2022,XX3498 POS WITHDRAWAL. WHEATSFIELD COOP AMES IA 68087201 245045,,-62.0,,31628.87,,0.0,Groceries
844,20220627000000[-6:CST]*-15.91*0**XX3498 POS PURCHASE AT SQ *CORNBRED BAR AMES IA 77041617 530869,06/27/2022,XX3498 POS PURCHASE AT SQ *CORNBRED BAR AMES IA 77041617 530869,,-15.91,,31690.87,,0.0,Food & Drink
845,20220627000000[-6:CST]*-9.72*0**XX3498 POS PURCHASE AT CAFE CREMERIE CHI CAGO IL 04349295 949533,06/27/2022,XX3498 POS PURCHASE AT CAFE CREMERIE CHI CAGO IL 04349295 949533,,-9.72,,31706.78,,0.0,Travel
846,20220627000000[-6:CST]*-6.00*0**XX3498 POS PURCHASE AT O DONNELL ACE HA AMES IA 78001897 347244,06/27/2022,XX3498 POS PURCHASE AT O DONNELL ACE HA AMES IA 78001897 347244,,-6.0,,31716.5,,0.0,Home
847,20220627000000[-6:CST]*15.00*501**XX3498 POS RETURN..... MED*MCFARLAND CL 515-239-4598 IA 53882370 712924,06/27/2022,XX3498 POS RETURN..... MED*MCFARLAND CL 515-239-4598 IA 53882370 712924,,,15.0,31722.5,,0.0,Deposit
848,20220624000000[-6:CST]*-105.09*0**CITY OF AMES UT BILL 002819790003022,06/24/2022,CITY OF AMES UT BILL 002819790003022,,-105.09,,31707.5,,0.0,Bills & Utilities
849,20220624000000[-6:CST]*-500.00*0**00548264 TRANSFER TO 780750 ON 6/24/22 A T 16:11,06/24/2022,00548264 TRANSFER TO 780750 ON 6/24/22 A T 16:11,,-500.0,,31812.59,,0.0,Personal
850,20220624000000[-6:CST]*3639.10*501**DONNELLEY FINANC DIRECT DEP 501067809056 L5Z,06/24/2022,DONNELLEY FINANC DIRECT DEP 501067809056 L5Z,,,3639.1,32312.59,,0.0,Deposit
851,20220623000000[-6:CST]*-425.35*0**FARMERS INS EFT PYMT mXXXXX5868,06/23/2022,FARMERS INS EFT PYMT mXXXXX5868,,-425.35,,28673.49,,0.0,Automotive
852,20220623000000[-6:CST]*-43.58*0**XX3498 POS PURCHASE AT POPS FOR CHAMPAG CHICAGO IL 70741570 273207,06/23/2022,XX3498 POS PURCHASE AT POPS FOR CHAMPAG CHICAGO IL 70741570 273207,,-43.58,,29098.84,,0.0,Travel
853,20220622000000[-6:CST]*-15690.00*1*1038*Check,06/22/2022,Check,,-15690.0,,29142.42,1038.0,0.0,Personal
854,20220621000000[-6:CST]*-45.05*0**Alliant - IPL PAYMENT 0061467186,06/21/2022,Alliant - IPL PAYMENT 0061467186,,-45.05,,44832.42,,0.0,Bills & Utilities
855,20220621000000[-6:CST]*-40.00*0**VENMO PAYMENT 1020786097639,06/21/2022,VENMO PAYMENT 1020786097639,,-40.0,,44877.47,,0.0,Personal
856,20220621000000[-6:CST]*-200.00*0**XX3498 ATM WITHDRAWAL. 405 5TH ST AMES I A IA000614 001996,06/21/2022,XX3498 ATM WITHDRAWAL. 405 5TH ST AMES I A IA000614 001996,,-200.0,,44917.47,,0.0,Personal
857,20220621000000[-6:CST]*-95.00*0**XX3498 POS PURCHASE AT HEROIC INK AMES I A 14100235 358914,06/21/2022,XX3498 POS PURCHASE AT HEROIC INK AMES I A 14100235 358914,,-95.0,,45117.47,,0.0,Personal
858,20220621000000[-6:CST]*-79.00*0**XX3498 POS WITHDRAWAL. WHEATSFIELD COOP AMES IA 68087201 732862,06/21/2022,XX3498 POS WITHDRAWAL. WHEATSFIELD COOP AMES IA 68087201 732862,,-79.0,,45212.47,,0.0,Groceries
859,20220621000000[-6:CST]*-46.34*0**XX3498 POS WITHDRAWAL. HY VEE 1018 AMES IA 001 936793,06/21/2022,XX3498 POS WITHDRAWAL. HY VEE 1018 AMES IA 001 936793,,-46.34,,45291.47,,0.0,Groceries
860,20220621000000[-6:CST]*-42.80*0**XX3498 POS PURCHASE AT BIG CREEK MARINA POLK CITY IA 11301233 862170,06/21/2022,XX3498 POS PURCHASE AT BIG CREEK MARINA POLK CITY IA 11301233 862170,,-42.8,,45337.81,,0.0,Entertainment
861,20220621000000[-6:CST]*-35.51*0**XX3498 POS WITHDRAWAL. HY VEE 1018 AMES IA 001 417679,06/21/2022,XX3498 POS WITHDRAWAL. HY VEE 1018 AMES IA 001 417679,,-35.51,,45380.61,,0.0,Groceries
862,20220621000000[-6:CST]*-35.10*0**XX3498 POS PURCHASE AT SQ *CORNBRED BAR Ames IA 86191222 834331,06/21/2022,XX3498 POS PURCHASE AT SQ *CORNBRED BAR Ames IA 86191222 834331,,-35.1,,45416.12,,0.0,Food & Drink
863,20220621000000[-6:CST]*-30.52*0**XX3498 POS PURCHASE AT SQ *CORNBRED BAR Ames IA 66245614 906888,06/21/2022,XX3498 POS PURCHASE AT SQ *CORNBRED BAR Ames IA 66245614 906888,,-30.52,,45451.22,,0.0,Food & Drink
864,20220621000000[-6:CST]*-14.00*0**XX3498 POS PURCHASE AT O DONNELL ACE HA AMES IA 71002541 871360,06/21/2022,XX3498 POS PURCHASE AT O DONNELL ACE HA AMES IA 71002541 871360,,-14.0,,45481.74,,0.0,Home
865,20220621000000[-6:CST]*-13.28*0**XX3498 POS WITHDRAWAL. WALGREENS 2719 G AMES IA 12108T21 000508,06/21/2022,XX3498 POS WITHDRAWAL. WALGREENS 2719 G AMES IA 12108T21 000508,,-13.28,,45495.74,,0.0,Groceries
866,20220621000000[-6:CST]*-12.31*0**XX3498 POS PURCHASE AT THE LOFT AMES IA 17732168 896413,06/21/2022,XX3498 POS PURCHASE AT THE LOFT AMES IA 17732168 896413,,-12.31,,45509.02,,0.0,Shopping
867,20220621000000[-6:CST]*-7.48*0**XX3498 POS PURCHASE AT TACO BELL #30421 AMES IA 09346488 625692,06/21/2022,XX3498 POS PURCHASE AT TACO BELL #30421 AMES IA 09346488 625692,,-7.48,,45521.33,,0.0,Food & Drink
868,20220617000000[-6:CST]*-24.60*0**CLUB FEES PLANET FIT 515-620-8880,06/17/2022,CLUB FEES PLANET FIT 515-620-8880,,-24.6,,45528.81,,0.0,Personal
869,20220617000000[-6:CST]*-43.66*0**XX3498 POS WITHDRAWAL. TARGET T-1170 Ame s IA 600001 003113,06/17/2022,XX3498 POS WITHDRAWAL. TARGET T-1170 Ame s IA 600001 003113,,-43.66,,45553.41,,0.0,Shopping
870,20220617000000[-6:CST]*-32.12*0**XX3498 POS PURCHASE AT SQ *CORNBRED BAR Ames IA 25383187 696830,06/17/2022,XX3498 POS PURCHASE AT SQ *CORNBRED BAR Ames IA 25383187 696830,,-32.12,,45597.07,,0.0,Food & Drink
871,20220617000000[-6:CST]*-29.00*0**XX3498 POS PURCHASE AT GOODWILL AMES AME S IA 99700040 066243,06/17/2022,XX3498 POS PURCHASE AT GOODWILL AMES AME S IA 99700040 066243,,-29.0,,45629.19,,0.0,Home
872,20220617000000[-6:CST]*-25.00*0**XX3498 POS PURCHASE AT SQ *ACPS Ames IA 48117276 922965,06/17/2022,XX3498 POS PURCHASE AT SQ *ACPS Ames IA 48117276 922965,,-25.0,,45658.19,,0.0,Entertainment
873,20220617000000[-6:CST]*-8.33*0**XX3498 POS PURCHASE AT TROPICAL SMOOTHI AMES IA 87732890 198613,06/17/2022,XX3498 POS PURCHASE AT TROPICAL SMOOTHI AMES IA 87732890 198613,,-8.33,,45683.19,,0.0,Food & Drink
874,20220616000000[-6:CST]*-46.33*0**XX3498 POS PURCHASE AT LOTF_1 AMES IA 00 512820 636850,06/16/2022,XX3498 POS PURCHASE AT LOTF_1 AMES IA 00 512820 636850,,-46.33,,45691.52,,0.0,Food & Drink
875,20220616000000[-6:CST]*-20.00*0**XX3498 POS WITHDRAWAL. HY VEE CLINIC 30 AMES IA 001 209866,06/16/2022,XX3498 POS WITHDRAWAL. HY VEE CLINIC 30 AMES IA 001 209866,,-20.0,,45737.85,,0.0,Groceries
876,20220615000000[-6:CST]*-230.38*0**VERIZON WIRELESS PAYMENTS 05885909720000 1,06/15/2022,VERIZON WIRELESS PAYMENTS 05885909720000 1,,-230.38,,45757.85,,0.0,Bills & Utilities
877,20220615000000[-6:CST]*-68.06*0**XX3498 POS WITHDRAWAL. HY VEE 1018 AMES IA 001 718558,06/15/2022,XX3498 POS WITHDRAWAL. HY VEE 1018 AMES IA 001 718558,,-68.06,,45988.23,,0.0,Groceries
878,20220615000000[-6:CST]*-32.47*0**XX3498 POS PURCHASE AT FLAME-N-SKEWER AM ES IA 19328553 559869,06/15/2022,XX3498 POS PURCHASE AT FLAME-N-SKEWER AM ES IA 19328553 559869,,-32.47,,46056.29,,0.0,Food & Drink
879,20220615000000[-6:CST]*-25.53*0**XX3498 POS PURCHASE AT SQ *CORNBRED BAR Ames IA 85823543 145536,06/15/2022,XX3498 POS PURCHASE AT SQ *CORNBRED BAR Ames IA 85823543 145536,,-25.53,,46088.76,,0.0,Food & Drink
880,20220614000000[-6:CST]*3.05*501**Interest paid,06/14/2022,Interest paid,,,3.05,46114.29,,0.0,Deposit
881,20220614000000[-6:CST]*-200.00*0**XX3498 ATM WITHDRAWAL. 405 5TH ST AMES I A IA000619 000692,06/14/2022,XX3498 ATM WITHDRAWAL. 405 5TH ST AMES I A IA000619 000692,,-200.0,,46111.24,,0.0,Personal
882,20220614000000[-6:CST]*-60.77*0**XX3498 POS WITHDRAWAL. WAL-MART #749 AME S IA 600001 016777,06/14/2022,XX3498 POS WITHDRAWAL. WAL-MART #749 AME S IA 600001 016777,,-60.77,,46311.24,,0.0,Groceries
883,20220614000000[-6:CST]*-22.25*0**XX3498 POS PURCHASE AT PERFECT GAMES AME S IA 09444939 575272,06/14/2022,XX3498 POS PURCHASE AT PERFECT GAMES AME S IA 09444939 575272,,-22.25,,46372.01,,0.0,Entertainment
884,20220613000000[-6:CST]*-48.18*0**Alliant - IPL PAYMENT 3836938783,06/13/2022,Alliant - IPL PAYMENT 3836938783,,-48.18,,46394.26,,0.0,Bills & Utilities
885,20220613000000[-6:CST]*-33.00*0**XX3498 POS PURCHASE AT O DONNELL ACE HA AMES IA 79000786 846088,06/13/2022,XX3498 POS PURCHASE AT O DONNELL ACE HA AMES IA 79000786 846088,,-33.0,,46442.44,,0.0,Home
886,20220613000000[-6:CST]*-13.41*0**XX3498 POS PURCHASE AT JIMMY JOHNS - 32 WAUKEE IA 04337574 826411,06/13/2022,XX3498 POS PURCHASE AT JIMMY JOHNS - 32 WAUKEE IA 04337574 826411,,-13.41,,46475.44,,0.0,Food & Drink
887,20220610000000[-6:CST]*-35.00*0**VENMO PAYMENT 1020583123208,06/10/2022,VENMO PAYMENT 1020583123208,,-35.0,,46488.85,,0.0,Personal
888,20220610000000[-6:CST]*3639.10*501**DONNELLEY FINANC DIRECT DEP 745060266392 L5Z,06/10/2022,DONNELLEY FINANC DIRECT DEP 745060266392 L5Z,,,3639.1,46523.85,,0.0,Deposit
889,20220609000000[-6:CST]*-39.64*0**XX3498 POS WITHDRAWAL. TARGET T-1170 Ame s IA 600001 003944,06/09/2022,XX3498 POS WITHDRAWAL. TARGET T-1170 Ame s IA 600001 003944,,-39.64,,42884.75,,0.0,Shopping
890,20220609000000[-6:CST]*-21.62*0**XX3498 POS PURCHASE AT FIVE GUYS 4031 Q AMES IA 24229322 744056,06/09/2022,XX3498 POS PURCHASE AT FIVE GUYS 4031 Q AMES IA 24229322 744056,,-21.62,,42924.39,,0.0,Food & Drink
891,20220608000000[-6:CST]*-73.82*0**XX3498 POS WITHDRAWAL. SAMSCLUB #6568 AM ES IA 24656801 891901,06/08/2022,XX3498 POS WITHDRAWAL. SAMSCLUB #6568 AM ES IA 24656801 891901,,-73.82,,42946.01,,0.0,Groceries
892,20220608000000[-6:CST]*-23.40*0**XX3498 POS PURCHASE AT SQ *CORNBRED BAR AMES IA 03190504 920188,06/08/2022,XX3498 POS PURCHASE AT SQ *CORNBRED BAR AMES IA 03190504 920188,,-23.4,,43019.83,,0.0,Food & Drink
893,20220607000000[-6:CST]*-755.51*0**CHASE CREDIT CRD AUTOPAY 000000000152811,06/07/2022,CHASE CREDIT CRD AUTOPAY 000000000152811,,-755.51,,43043.23,,0.0,Bills & Utilities
894,20220607000000[-6:CST]*-146.68*0**XX3498 POS WITHDRAWAL. HY VEE 1018 AMES IA 001 998812,06/07/2022,XX3498 POS WITHDRAWAL. HY VEE 1018 AMES IA 001 998812,,-146.68,,43798.74,,0.0,Groceries
895,20220607000000[-6:CST]*-60.00*0**XX3498 POS WITHDRAWAL. WHEATSFIELD COOP AMES IA 68087201 847681,06/07/2022,XX3498 POS WITHDRAWAL. WHEATSFIELD COOP AMES IA 68087201 847681,,-60.0,,43945.42,,0.0,Groceries
896,20220607000000[-6:CST]*-39.00*0**XX3498 POS PURCHASE AT PERFECT GAMES AME S IA 56407056 197588,06/07/2022,XX3498 POS PURCHASE AT PERFECT GAMES AME S IA 56407056 197588,,-39.0,,44005.42,,0.0,Entertainment
897,20220607000000[-6:CST]*-8.56*0**XX3498 POS PURCHASE AT PERFECT GAMES AME S IA 56406207 171217,06/07/2022,XX3498 POS PURCHASE AT PERFECT GAMES AME S IA 56406207 171217,,-8.56,,44044.42,,0.0,Entertainment
898,20220607000000[-6:CST]*-3.25*0**XX3498 POS PURCHASE AT SUPER SHINE AMES AMES IA 78706800 867129,06/07/2022,XX3498 POS PURCHASE AT SUPER SHINE AMES AMES IA 78706800 867129,,-3.25,,44052.98,,0.0,Automotive
899,20220606000000[-6:CST]*-712.75*0**IOWA BANKERS MTG ACH PMT XXXXXX2430,06/06/2022,IOWA BANKERS MTG ACH PMT XXXXXX2430,,-712.75,,44056.23,,0.0,Home
900,20220606000000[-6:CST]*-200.00*0**XX3498 ATM WITHDRAWAL. 405 5TH ST AMES I A IA000619 000520,06/06/2022,XX3498 ATM WITHDRAWAL. 405 5TH ST AMES I A IA000619 000520,,-200.0,,44768.98,,0.0,Personal
901,20220606000000[-6:CST]*-200.00*0**XX3498 ATM WITHDRAWAL. 405 5TH ST AMES I A IA000619 000455,06/06/2022,XX3498 ATM WITHDRAWAL. 405 5TH ST AMES I A IA000619 000455,,-200.0,,44968.98,,0.0,Personal
902,20220606000000[-6:CST]*-85.00*0**XX3498 POS WITHDRAWAL. WHEATSFIELD COOP AMES IA 68087201 399222,06/06/2022,XX3498 POS WITHDRAWAL. WHEATSFIELD COOP AMES IA 68087201 399222,,-85.0,,45168.98,,0.0,Groceries
903,20220606000000[-6:CST]*-30.36*0**XX3498 POS PURCHASE AT SQ *CORNBRED BAR Ames IA 79958074 804070,06/06/2022,XX3498 POS PURCHASE AT SQ *CORNBRED BAR Ames IA 79958074 804070,,-30.36,,45253.98,,0.0,Food & Drink
904,20220606000000[-6:CST]*-23.12*0**XX3498 POS PURCHASE AT FLAME-N-SKEWER AM ES IA 19328549 898845,06/06/2022,XX3498 POS PURCHASE AT FLAME-N-SKEWER AM ES IA 19328549 898845,,-23.12,,45284.34,,0.0,Food & Drink
905,20220606000000[-6:CST]*-22.97*0**XX3498 POS WITHDRAWAL. KUMGO 1215 AMES AMES IA 001 809614,06/06/2022,XX3498 POS WITHDRAWAL. KUM&GO 1215 AMES AMES IA 001 809614,,-22.97,,45307.46,,0.0,Gas
906,20220606000000[-6:CST]*-20.66*0**XX3498 POS PURCHASE AT SQ *CORNBRED BAR AMES IA 77993422 461848,06/06/2022,XX3498 POS PURCHASE AT SQ *CORNBRED BAR AMES IA 77993422 461848,,-20.66,,45330.43,,0.0,Food & Drink
907,20220603000000[-6:CST]*-73.03*0**XX3498 POS PURCHASE AT PERFECT GAMES AME S IA 90448667 351267,06/03/2022,XX3498 POS PURCHASE AT PERFECT GAMES AME S IA 90448667 351267,,-73.03,,45351.09,,0.0,Entertainment
908,20220602000000[-6:CST]*-20.66*0**XX3498 POS PURCHASE AT SQ *CORNBRED BAR AMES IA 76663649 739094,06/02/2022,XX3498 POS PURCHASE AT SQ *CORNBRED BAR AMES IA 76663649 739094,,-20.66,,45424.12,,0.0,Food & Drink
909,20220601000000[-6:CST]*-200.00*0**XX3498 ATM WITHDRAWAL. 405 5TH ST AMES I A IA000614 000732,06/01/2022,XX3498 ATM WITHDRAWAL. 405 5TH ST AMES I A IA000614 000732,,-200.0,,45444.78,,0.0,Personal
910,20220601000000[-6:CST]*-41.06*0**XX3498 POS PURCHASE AT SQ *CORNBRED BAR Ames IA 18349178 398447,06/01/2022,XX3498 POS PURCHASE AT SQ *CORNBRED BAR Ames IA 18349178 398447,,-41.06,,45644.78,,0.0,Food & Drink
911,20220601000000[-6:CST]*-28.00*0**XX3498 POS PURCHASE AT KWIK STOP LIQUOR AMES IA 05254301 800514,06/01/2022,XX3498 POS PURCHASE AT KWIK STOP LIQUOR AMES IA 05254301 800514,,-28.0,,45685.84,,0.0,Food & Drink
912,20220531000000[-6:CST]*-40.51*0**XX3498 POS WITHDRAWAL. Wal-Mart Super C AMES IA 07490046 215071312199,05/31/2022,XX3498 POS WITHDRAWAL. Wal-Mart Super C AMES IA 07490046 215071312199,,-40.51,,45713.84,,0.0,Groceries
913,20220531000000[-6:CST]*-32.00*0**XX3498 POS WITHDRAWAL. WALGREENS 2719 G AMES IA 12108T21 254845,05/31/2022,XX3498 POS WITHDRAWAL. WALGREENS 2719 G AMES IA 12108T21 254845,,-32.0,,45754.35,,0.0,Groceries
914,20220531000000[-6:CST]*-25.40*0**XX3498 POS PURCHASE AT SQ *CORNBRED BAR Ames IA 75021511 222246,05/31/2022,XX3498 POS PURCHASE AT SQ *CORNBRED BAR Ames IA 75021511 222246,,-25.4,,45786.35,,0.0,Food & Drink
915,20220531000000[-6:CST]*-9.93*0**XX3498 POS WITHDRAWAL. MCDONALD'S F1228 STUART IA 46825804 880024,05/31/2022,XX3498 POS WITHDRAWAL. MCDONALD'S F1228 STUART IA 46825804 880024,,-9.93,,45811.75,,0.0,Food & Drink
916,20220531000000[-6:CST]*-9.51*0**XX3498 POS PURCHASE AT B BOPS AMES NORT AMES IA 29019241 353942,05/31/2022,XX3498 POS PURCHASE AT B BOPS AMES NORT AMES IA 29019241 353942,,-9.51,,45821.68,,0.0,Food & Drink
917,20220531000000[-6:CST]*-5.39*0**XX3498 POS WITHDRAWAL. GATEWAYEXPRESS AM ES IA 0004L710 215087091885,05/31/2022,XX3498 POS WITHDRAWAL. GATEWAYEXPRESS AM ES IA 0004L710 215087091885,,-5.39,,45831.19,,0.0,Automotive
918,20220531000000[-6:CST]*-3.00*0**XX3498 POS PURCHASE AT WOF COFFEE ROAST CEDAR RAPIDS IA 92000198 838207,05/31/2022,XX3498 POS PURCHASE AT WOF COFFEE ROAST CEDAR RAPIDS IA 92000198 838207,,-3.0,,45836.58,,0.0,Personal
919,20220531000000[-6:CST]*-600.00*0**Miscellaneous Debit,05/31/2022,Miscellaneous Debit,,-600.0,,45839.58,,0.0,Personal
920,20220527000000[-6:CST]*-86.21*0**CITY OF AMES UT BILL 002629810006826,05/27/2022,CITY OF AMES UT BILL 002629810006826,,-86.21,,46439.58,,0.0,Bills & Utilities
921,20220527000000[-6:CST]*-71.23*0**XX3498 POS WITHDRAWAL. ALDI 72048 AMES I A 88741003 203767,05/27/2022,XX3498 POS WITHDRAWAL. ALDI 72048 AMES I A 88741003 203767,,-71.23,,46525.79,,0.0,Groceries
922,20220527000000[-6:CST]*3639.11*501**DONNELLEY FINANC DIRECT DEP 932623509593 L5Z,05/27/2022,DONNELLEY FINANC DIRECT DEP 932623509593 L5Z,,,3639.11,46597.02,,0.0,Deposit
923,20220526000000[-6:CST]*-200.00*0**XX3498 ATM WITHDRAWAL. 2406 GRAND AVE AM ES IA IA000624 000051,05/26/2022,XX3498 ATM WITHDRAWAL. 2406 GRAND AVE AM ES IA IA000624 000051,,-200.0,,42957.91,,0.0,Personal
924,20220526000000[-6:CST]*-70.50*0**XX3498 POS PURCHASE AT PERFECT GAMES AME S IA 93086039 698399,05/26/2022,XX3498 POS PURCHASE AT PERFECT GAMES AME S IA 93086039 698399,,-70.5,,43157.91,,0.0,Entertainment
925,20220526000000[-6:CST]*-12.84*0**XX3498 POS PURCHASE AT PERFECT GAMES AME S IA 93086096 273420,05/26/2022,XX3498 POS PURCHASE AT PERFECT GAMES AME S IA 93086096 273420,,-12.84,,43228.41,,0.0,Entertainment
926,20220526000000[-6:CST]*-10.50*0**XX3498 POS PURCHASE AT SQ *LONDON UNDER Ames IA 79003656 118599,05/26/2022,XX3498 POS PURCHASE AT SQ *LONDON UNDER Ames IA 79003656 118599,,-10.5,,43241.25,,0.0,Food & Drink
927,20220525000000[-6:CST]*-99.73*0**CITY OF AMES UT BILL 002819790003022,05/25/2022,CITY OF AMES UT BILL 002819790003022,,-99.73,,43251.75,,0.0,Bills & Utilities
928,20220525000000[-6:CST]*-26.77*0**XX3498 POS PURCHASE AT SQ *CORNBRED BAR Ames IA 41502174 696848,05/25/2022,XX3498 POS PURCHASE AT SQ *CORNBRED BAR Ames IA 41502174 696848,,-26.77,,43351.48,,0.0,Food & Drink
929,20220524000000[-6:CST]*-34.75*0**XX3498 POS PURCHASE AT SQ *LONDON UNDER Ames IA 74899726 068048,05/24/2022,XX3498 POS PURCHASE AT SQ *LONDON UNDER Ames IA 74899726 068048,,-34.75,,43378.25,,0.0,Food & Drink
930,20220524000000[-6:CST]*-27.50*0**XX3498 POS PURCHASE AT PERFECT GAMES AME S IA 66200743 938378,05/24/2022,XX3498 POS PURCHASE AT PERFECT GAMES AME S IA 66200743 938378,,-27.5,,43413.0,,0.0,Entertainment
931,20220524000000[-6:CST]*-12.13*0**XX3498 POS PURCHASE AT TACO BELL #30421 AMES IA 01083346 845096,05/24/2022,XX3498 POS PURCHASE AT TACO BELL #30421 AMES IA 01083346 845096,,-12.13,,43440.5,,0.0,Food & Drink
932,20220523000000[-6:CST]*-425.37*0**FARMERS INS EFT PYMT mXXXXX5868,05/23/2022,FARMERS INS EFT PYMT mXXXXX5868,,-425.37,,43452.63,,0.0,Automotive
933,20220523000000[-6:CST]*-40.00*0**VENMO PAYMENT 1020218296787,05/23/2022,VENMO PAYMENT 1020218296787,,-40.0,,43878.0,,0.0,Personal
934,20220523000000[-6:CST]*-54.00*0**XX3498 POS WITHDRAWAL. WALGREENS 2719 G AMES IA 12108T22 051603,05/23/2022,XX3498 POS WITHDRAWAL. WALGREENS 2719 G AMES IA 12108T22 051603,,-54.0,,43918.0,,0.0,Groceries
935,20220523000000[-6:CST]*-46.92*0**XX3498 POS PURCHASE AT LA CASA MAYA AMES IA 02604461 352145,05/23/2022,XX3498 POS PURCHASE AT LA CASA MAYA AMES IA 02604461 352145,,-46.92,,43972.0,,0.0,Food & Drink
936,20220523000000[-6:CST]*-42.00*0**XX3498 POS PURCHASE AT CASEYS #2905 AMES IA 600001 042636,05/23/2022,XX3498 POS PURCHASE AT CASEYS #2905 AMES IA 600001 042636,,-42.0,,44018.92,,0.0,Gas
937,20220523000000[-6:CST]*-40.98*0**XX3498 POS PURCHASE AT SQ *CORNBRED BAR Ames IA 18992347 690898,05/23/2022,XX3498 POS PURCHASE AT SQ *CORNBRED BAR Ames IA 18992347 690898,,-40.98,,44060.92,,0.0,Food & Drink
938,20220523000000[-6:CST]*-30.82*0**XX3498 POS PURCHASE AT SQ *CORNBRED BAR Ames IA 09366770 890671,05/23/2022,XX3498 POS PURCHASE AT SQ *CORNBRED BAR Ames IA 09366770 890671,,-30.82,,44101.9,,0.0,Food & Drink
939,20220523000000[-6:CST]*-26.77*0**XX3498 POS PURCHASE AT SQ *CORNBRED BAR Ames IA 96766402 503789,05/23/2022,XX3498 POS PURCHASE AT SQ *CORNBRED BAR Ames IA 96766402 503789,,-26.77,,44132.72,,0.0,Food & Drink
940,20220523000000[-6:CST]*-9.83*0**XX3498 POS PURCHASE AT CULVERS OF AMES A MES IA 00149115 606078,05/23/2022,XX3498 POS PURCHASE AT CULVERS OF AMES A MES IA 00149115 606078,,-9.83,,44159.49,,0.0,Food & Drink
941,20220523000000[-6:CST]*-100.00*0**00052273 TRANSFER TO 780750 ON 5/23/22 A T 13:57,05/23/2022,00052273 TRANSFER TO 780750 ON 5/23/22 A T 13:57,,-100.0,,44169.32,,0.0,Personal
942,20220520000000[-6:CST]*-90.75*0**Alliant - IPL PAYMENT 0061467186,05/20/2022,Alliant - IPL PAYMENT 0061467186,,-90.75,,44269.32,,0.0,Bills & Utilities
943,20220519000000[-6:CST]*-251.05*0**XX3498 POS WITHDRAWAL. Wal-Mart Super C AMES IA 07490046 213993002354,05/19/2022,XX3498 POS WITHDRAWAL. Wal-Mart Super C AMES IA 07490046 213993002354,,-251.05,,44360.07,,0.0,Groceries
944,20220519000000[-6:CST]*-200.00*0**XX3498 ATM WITHDRAWAL. 3725 STANGE ROAD AMES IA 5719G113 491068,05/19/2022,XX3498 ATM WITHDRAWAL. 3725 STANGE ROAD AMES IA 5719G113 491068,,-200.0,,44611.12,,0.0,Personal
945,20220519000000[-6:CST]*-67.50*0**XX3498 POS PURCHASE AT SQ *LONDON UNDER Ames IA 35614109 562324,05/19/2022,XX3498 POS PURCHASE AT SQ *LONDON UNDER Ames IA 35614109 562324,,-67.5,,44811.12,,0.0,Food & Drink
946,20220519000000[-6:CST]*-58.00*0**XX3498 POS PURCHASE AT SQ *THE ANGRY IR Ames IA 82893844 925402,05/19/2022,XX3498 POS PURCHASE AT SQ *THE ANGRY IR Ames IA 82893844 925402,,-58.0,,44878.62,,0.0,Food & Drink
947,20220519000000[-6:CST]*-20.66*0**XX3498 POS PURCHASE AT SQ *CORNBRED BAR Ames IA 57443567 883503,05/19/2022,XX3498 POS PURCHASE AT SQ *CORNBRED BAR Ames IA 57443567 883503,,-20.66,,44936.62,,0.0,Food & Drink
948,20220518000000[-6:CST]*-2664.00*0**DHS CSRU IOW DHS IOWDHS011426109,05/18/2022,DHS CSRU IOW DHS IOWDHS011426109,,-2664.0,,44957.28,,0.0,Bills & Utilities
949,20220518000000[-6:CST]*-0.29*0**DHS CSRU conv fee IOWDHS011426110,05/18/2022,DHS CSRU conv fee IOWDHS011426110,,-0.29,,47621.28,,0.0,Bills & Utilities
950,20220518000000[-6:CST]*-39.50*0**XX3498 POS PURCHASE AT SQ *LONDON UNDER Ames IA 15661539 376648,05/18/2022,XX3498 POS PURCHASE AT SQ *LONDON UNDER Ames IA 15661539 376648,,-39.5,,47621.57,,0.0,Food & Drink
951,20220517000000[-6:CST]*-24.60*0**CLUB FEES PLANET FIT 515-620-8880,05/17/2022,CLUB FEES PLANET FIT 515-620-8880,,-24.6,,47661.07,,0.0,Personal
952,20220517000000[-6:CST]*-50.75*0**XX3498 POS PURCHASE AT PERFECT GAMES AME S IA 92285235 642213,05/17/2022,XX3498 POS PURCHASE AT PERFECT GAMES AME S IA 92285235 642213,,-50.75,,47685.67,,0.0,Entertainment
953,20220517000000[-6:CST]*-19.80*0**XX3498 POS PURCHASE AT SQ *THE FLYING E Marshalltown IA 15636724 560678,05/17/2022,XX3498 POS PURCHASE AT SQ *THE FLYING E Marshalltown IA 15636724 560678,,-19.8,,47736.42,,0.0,Food & Drink
954,20220516000000[-6:CST]*-230.38*0**VERIZON WIRELESS PAYMENTS 05885909720000 1,05/16/2022,VERIZON WIRELESS PAYMENTS 05885909720000 1,,-230.38,,47756.22,,0.0,Bills & Utilities
955,20220516000000[-6:CST]*-45.00*0**VENMO PAYMENT 1020126562512,05/16/2022,VENMO PAYMENT 1020126562512,,-45.0,,47986.6,,0.0,Personal
956,20220516000000[-6:CST]*-25.00*0**VENMO PAYMENT 1020126578438,05/16/2022,VENMO PAYMENT 1020126578438,,-25.0,,48031.6,,0.0,Personal
957,20220516000000[-6:CST]*-33.53*0**XX3498 POS PURCHASE AT BOULDER TAP HOUS AMES IA 88301021 648984,05/16/2022,XX3498 POS PURCHASE AT BOULDER TAP HOUS AMES IA 88301021 648984,,-33.53,,48056.6,,0.0,Food & Drink
958,20220516000000[-6:CST]*-25.47*0**XX3498 POS PURCHASE AT SQ *CORNBRED BAR Ames IA 81437804 811476,05/16/2022,XX3498 POS PURCHASE AT SQ *CORNBRED BAR Ames IA 81437804 811476,,-25.47,,48090.13,,0.0,Food & Drink
959,20220516000000[-6:CST]*-20.66*0**XX3498 POS PURCHASE AT SQ *CORNBRED BAR AMES IA 48158597 137409,05/16/2022,XX3498 POS PURCHASE AT SQ *CORNBRED BAR AMES IA 48158597 137409,,-20.66,,48115.6,,0.0,Food & Drink
960,20220516000000[-6:CST]*-19.50*0**XX3498 POS PURCHASE AT PERFECT GAMES AME S IA 05453338 338832,05/16/2022,XX3498 POS PURCHASE AT PERFECT GAMES AME S IA 05453338 338832,,-19.5,,48136.26,,0.0,Entertainment
961,20220516000000[-6:CST]*-12.84*0**XX3498 POS PURCHASE AT PERFECT GAMES AME S IA 05453502 060200,05/16/2022,XX3498 POS PURCHASE AT PERFECT GAMES AME S IA 05453502 060200,,-12.84,,48155.76,,0.0,Entertainment
962,20220516000000[-6:CST]*-6.35*0**XX3498 POS PURCHASE AT TST* Burgies Cof Ames IA 70416806 924084,05/16/2022,XX3498 POS PURCHASE AT TST* Burgies Cof Ames IA 70416806 924084,,-6.35,,48168.6,,0.0,Food & Drink
963,20220513000000[-6:CST]*-118.99*0**Alliant - IPL PAYMENT 3836938783,05/13/2022,Alliant - IPL PAYMENT 3836938783,,-118.99,,48174.95,,0.0,Bills & Utilities
964,20220513000000[-6:CST]*-200.00*0**XX3498 ATM WITHDRAWAL. 405 5TH ST AMES I A 619206 000017,05/13/2022,XX3498 ATM WITHDRAWAL. 405 5TH ST AMES I A 619206 000017,,-200.0,,48293.94,,0.0,Personal
965,20220513000000[-6:CST]*-25.00*0**XX3498 POS PURCHASE AT SQ *ACPS Ames IA 24453167 470307,05/13/2022,XX3498 POS PURCHASE AT SQ *ACPS Ames IA 24453167 470307,,-25.0,,48493.94,,0.0,Entertainment
966,20220513000000[-6:CST]*-17.43*0**XX3498 POS PURCHASE AT HY-VEE AMES 2 MK AMES IA 09187549 292182,05/13/2022,XX3498 POS PURCHASE AT HY-VEE AMES 2 MK AMES IA 09187549 292182,,-17.43,,48518.94,,0.0,Groceries
967,20220513000000[-6:CST]*3639.10*501**DONNELLEY FINANC DIRECT DEP 927823417610 L5Z,05/13/2022,DONNELLEY FINANC DIRECT DEP 927823417610 L5Z,,,3639.1,48536.37,,0.0,Deposit
968,20220512000000[-6:CST]*-78.00*0**XX3498 POS WITHDRAWAL. WHEATSFIELD COO A MES IA 68087201 901622,05/12/2022,XX3498 POS WITHDRAWAL. WHEATSFIELD COO A MES IA 68087201 901622,,-78.0,,44897.27,,0.0,Groceries
969,20220511000000[-6:CST]*-52.49*0**XX3498 POS PURCHASE AT JIFFY LUBE #342 A MES IA 00098514 352367,05/11/2022,XX3498 POS PURCHASE AT JIFFY LUBE #342 A MES IA 00098514 352367,,-52.49,,44975.27,,0.0,Automotive
970,20220511000000[-6:CST]*-42.00*0**XX3498 POS WITHDRAWAL. WHEATSFIELD COO A MES IA 68087201 905662,05/11/2022,XX3498 POS WITHDRAWAL. WHEATSFIELD COO A MES IA 68087201 905662,,-42.0,,45027.76,,0.0,Groceries
971,20220511000000[-6:CST]*-27.66*0**XX3498 POS PURCHASE AT SQ *CORNBRED BAR Ames IA 90111745 487975,05/11/2022,XX3498 POS PURCHASE AT SQ *CORNBRED BAR Ames IA 90111745 487975,,-27.66,,45069.76,,0.0,Food & Drink
972,20220511000000[-6:CST]*-7.42*0**XX3498 POS PURCHASE AT SQ *CAFE DIEM Ame s IA 63005199 346019,05/11/2022,XX3498 POS PURCHASE AT SQ *CAFE DIEM Ame s IA 63005199 346019,,-7.42,,45097.42,,0.0,Food & Drink
973,20220510000000[-6:CST]*2.96*501**Interest paid,05/10/2022,Interest paid,,,2.96,45104.84,,0.0,Deposit
974,20220510000000[-6:CST]*-2146.00*1*1037*Check,05/10/2022,Check,,-2146.0,,45101.88,1037.0,0.0,Personal
975,20220510000000[-6:CST]*-70.08*0**XX3498 POS PURCHASE AT PERFECT GAMES AME S IA 39473046 005696,05/10/2022,XX3498 POS PURCHASE AT PERFECT GAMES AME S IA 39473046 005696,,-70.08,,47247.88,,0.0,Entertainment
976,20220510000000[-6:CST]*-25.44*0**XX3498 POS WITHDRAWAL. ADVANCE AUTO PA A MES IA 12204901 752964,05/10/2022,XX3498 POS WITHDRAWAL. ADVANCE AUTO PA A MES IA 12204901 752964,,-25.44,,47317.96,,0.0,Automotive
977,20220509000000[-6:CST]*-200.00*0**XX3498 ATM WITHDRAWAL. 405 5TH ST AMES I A 610801 374,05/09/2022,XX3498 ATM WITHDRAWAL. 405 5TH ST AMES I A 610801 374,,-200.0,,47343.4,,0.0,Personal
978,20220509000000[-6:CST]*-133.49*0**XX3498 POS WITHDRAWAL. ALDI 72048 AMES I A 88741003 708750,05/09/2022,XX3498 POS WITHDRAWAL. ALDI 72048 AMES I A 88741003 708750,,-133.49,,47543.4,,0.0,Groceries
979,20220509000000[-6:CST]*-122.45*0**XX3498 POS PURCHASE AT AUNT MAUDES AMES IA 75769966 212900180979,05/09/2022,XX3498 POS PURCHASE AT AUNT MAUDES AMES IA 75769966 212900180979,,-122.45,,47676.89,,0.0,Food & Drink
980,20220509000000[-6:CST]*-113.00*0**XX3498 POS WITHDRAWAL. WHEATSFIELD COO A MES IA 68087201 583309,05/09/2022,XX3498 POS WITHDRAWAL. WHEATSFIELD COO A MES IA 68087201 583309,,-113.0,,47799.34,,0.0,Groceries
981,20220509000000[-6:CST]*-51.65*0**XX3498 POS PURCHASE AT PHO  TEA CAFE LL C AMES IA 8641 212800074284,05/09/2022,XX3498 POS PURCHASE AT PHO & TEA CAFE LL C AMES IA 8641 212800074284,,-51.65,,47912.34,,0.0,Food & Drink
982,20220509000000[-6:CST]*-38.75*0**XX3498 POS PURCHASE AT SQ *CORNBRED BARB ECUE AMES IA 372038000053360 2127,05/09/2022,XX3498 POS PURCHASE AT SQ *CORNBRED BARB ECUE AMES IA 372038000053360 2127,,-38.75,,47963.99,,0.0,Food & Drink
983,20220509000000[-6:CST]*-33.00*0**XX3498 POS WITHDRAWAL. WALGREENS 2719 GR AND A AMES IA 12108T22 13507528,05/09/2022,XX3498 POS WITHDRAWAL. WALGREENS 2719 GR AND A AMES IA 12108T22 13507528,,-33.0,,48002.74,,0.0,Groceries
984,20220509000000[-6:CST]*-12.13*0**XX3498 POS PURCHASE AT TACO BELL #30421 AMES IA 0090 212900082161,05/09/2022,XX3498 POS PURCHASE AT TACO BELL #30421 AMES IA 0090 212900082161,,-12.13,,48035.74,,0.0,Food & Drink
985,20220509000000[-6:CST]*-6.69*0**XX3498 POS PURCHASE AT PHO  TEA CAFE LL C AMES IA 8641 212800074285,05/09/2022,XX3498 POS PURCHASE AT PHO & TEA CAFE LL C AMES IA 8641 212800074285,,-6.69,,48047.87,,0.0,Food & Drink
986,20220506000000[-6:CST]*-3581.71*0**CHASE CREDIT CRD AUTOPAY 000000000151578,05/06/2022,CHASE CREDIT CRD AUTOPAY 000000000151578,,-3581.71,,48054.56,,0.0,Bills & Utilities
987,20220506000000[-6:CST]*-66.01*0**XX3498 POS PURCHASE AT SQ *CORNBRED BARB ECUE Ames IA 372038000053360 2126,05/06/2022,XX3498 POS PURCHASE AT SQ *CORNBRED BARB ECUE Ames IA 372038000053360 2126,,-66.01,,51636.27,,0.0,Food & Drink
988,20220505000000[-6:CST]*-712.75*0**IOWA BANKERS MTG ACH PMT XXXXXX2430,05/05/2022,IOWA BANKERS MTG ACH PMT XXXXXX2430,,-712.75,,51702.28,,0.0,Home
989,20220505000000[-6:CST]*-200.00*0**XX3498 ATM WITHDRAWAL. 405 5TH ST AMES I A 610801 124,05/05/2022,XX3498 ATM WITHDRAWAL. 405 5TH ST AMES I A 610801 124,,-200.0,,52415.03,,0.0,Personal
990,20220505000000[-6:CST]*-51.92*0**XX3498 POS PURCHASE AT SQ *CORNBRED BARB ECUE Ames IA 372038000053360 2125,05/05/2022,XX3498 POS PURCHASE AT SQ *CORNBRED BARB ECUE Ames IA 372038000053360 2125,,-51.92,,52615.03,,0.0,Food & Drink
991,20220505000000[-6:CST]*-30.00*0**XX3498 POS PURCHASE AT O DONNELL ACE HAR DWARE AMES IA 7137 212500119894,05/05/2022,XX3498 POS PURCHASE AT O DONNELL ACE HAR DWARE AMES IA 7137 212500119894,,-30.0,,52666.95,,0.0,Home
992,20220504000000[-6:CST]*-1444.13*0**InstaMed MCFARLAND 021000028725387,05/04/2022,InstaMed MCFARLAND 021000028725387,,-1444.13,,52696.95,,0.0,Health & Wellness
993,20220504000000[-6:CST]*-33.56*0**XX3498 POS PURCHASE AT SQ *CORNBRED BARB ECUE Ames IA 372041000053360 2124,05/04/2022,XX3498 POS PURCHASE AT SQ *CORNBRED BARB ECUE Ames IA 372041000053360 2124,,-33.56,,54141.08,,0.0,Food & Drink
994,20220503000000[-6:CST]*-26.00*0**RENT ON SAFE DEPOSIT BOX 10000703,05/03/2022,RENT ON SAFE DEPOSIT BOX 10000703,,-26.0,,54174.64,,0.0,Personal
995,20220503000000[-6:CST]*-25.15*0**XX3498 POS PURCHASE AT NORTH GRAND CINEM A AMES IA 650000012154665 2123001,05/03/2022,XX3498 POS PURCHASE AT NORTH GRAND CINEM A AMES IA 650000012154665 2123001,,-25.15,,54200.64,,0.0,Entertainment
996,20220502000000[-6:CST]*-3000.00*1*1036*Check,05/02/2022,Check,,-3000.0,,54225.79,1036.0,0.0,Personal
997,20220502000000[-6:CST]*-118.12*1*1035*Check,05/02/2022,Check,,-118.12,,57225.79,1035.0,0.0,Personal
998,20220502000000[-6:CST]*-200.00*0**XX3498 ATM WITHDRAWAL. 405 5TH ST AMES I A 610801 330,05/02/2022,XX3498 ATM WITHDRAWAL. 405 5TH ST AMES I A 610801 330,,-200.0,,57343.91,,0.0,Personal
999,20220502000000[-6:CST]*-89.00*0**XX3498 POS WITHDRAWAL. WHEATSFIELD COO A MES IA 68087201 08722514,05/02/2022,XX3498 POS WITHDRAWAL. WHEATSFIELD COO A MES IA 68087201 08722514,,-89.0,,57543.91,,0.0,Groceries
1000,20220502000000[-6:CST]*-71.75*0**XX3498 POS WITHDRAWAL. WAL-MART #0749 AM ES IA 24074901 07491624,05/02/2022,XX3498 POS WITHDRAWAL. WAL-MART #0749 AM ES IA 24074901 07491624,,-71.75,,57632.91,,0.0,Groceries
1001,20220502000000[-6:CST]*-31.42*0**XX3498 POS PURCHASE AT SQ *CORNBRED BARB ECUE Ames IA 372041000053360 2120,05/02/2022,XX3498 POS PURCHASE AT SQ *CORNBRED BARB ECUE Ames IA 372041000053360 2120,,-31.42,,57704.66,,0.0,Food & Drink
1002,20220502000000[-6:CST]*-26.05*0**XX3498 POS PURCHASE AT CYCLONE LIQUORS 3 AMES IA 4445032726275 2120001550,05/02/2022,XX3498 POS PURCHASE AT CYCLONE LIQUORS 3 AMES IA 4445032726275 2120001550,,-26.05,,57736.08,,0.0,Food & Drink
1003,20220502000000[-6:CST]*-14.24*0**XX3498 POS PURCHASE AT SQ *CORNBRED BARB ECUE Ames IA 372041000053360 2122,05/02/2022,XX3498 POS PURCHASE AT SQ *CORNBRED BARB ECUE Ames IA 372041000053360 2122,,-14.24,,57762.13,,0.0,Food & Drink
1004,20220502000000[-6:CST]*-7.78*0**XX3498 POS WITHDRAWAL. FAREWAY STORES #3 86 AMES IA 92405701 29098800,05/02/2022,XX3498 POS WITHDRAWAL. FAREWAY STORES #3 86 AMES IA 92405701 29098800,,-7.78,,57776.37,,0.0,Groceries
1005,20220502000000[-6:CST]*-6.42*0**XX3498 POS PURCHASE AT ARBY S 5537 AMES IA 4445026648220 212000087913,05/02/2022,XX3498 POS PURCHASE AT ARBY S 5537 AMES IA 4445026648220 212000087913,,-6.42,,57784.15,,0.0,Food & Drink
1006,20220429000000[-6:CST]*-20.66*0**XX3498 POS PURCHASE AT SQ *CORNBRED BARB ECUE Ames IA 372041000053360 2119,04/29/2022,XX3498 POS PURCHASE AT SQ *CORNBRED BARB ECUE Ames IA 372041000053360 2119,,-20.66,,57790.57,,0.0,Food & Drink
1007,20220429000000[-6:CST]*3639.10*501**DONNELLEY FINANC DIRECT DEP 589058195127 L5Z,04/29/2022,DONNELLEY FINANC DIRECT DEP 589058195127 L5Z,,,3639.1,57811.23,,0.0,Deposit
1008,20220428000000[-6:CST]*-59.04*0**XX3498 POS PURCHASE AT SQ *CORNBRED BARB ECUE Ames IA 372041000053360 2118,04/28/2022,XX3498 POS PURCHASE AT SQ *CORNBRED BARB ECUE Ames IA 372041000053360 2118,,-59.04,,54172.13,,0.0,Food & Drink
1009,20220428000000[-6:CST]*-52.81*0**XX3498 POS PURCHASE AT Mucky Duck Pub Am es IA 513331030178305 21180007923,04/28/2022,XX3498 POS PURCHASE AT Mucky Duck Pub Am es IA 513331030178305 21180007923,,-52.81,,54231.17,,0.0,Food & Drink
1010,20220428000000[-6:CST]*-29.50*0**XX3498 POS PURCHASE AT PHO  TEA CAFE LL C AMES IA 8641 211800078880,04/28/2022,XX3498 POS PURCHASE AT PHO & TEA CAFE LL C AMES IA 8641 211800078880,,-29.5,,54283.98,,0.0,Food & Drink
1011,20220427000000[-6:CST]*-84.47*0**CITY OF AMES UT BILL 002629810006826,04/27/2022,CITY OF AMES UT BILL 002629810006826,,-84.47,,54313.48,,0.0,Bills & Utilities
1012,20220427000000[-6:CST]*-34.86*0**XX3498 POS PURCHASE AT Wal-Mart Super Ce nter AMES IA 07490046 08141716,04/27/2022,XX3498 POS PURCHASE AT Wal-Mart Super Ce nter AMES IA 07490046 08141716,,-34.86,,54397.95,,0.0,Groceries
1013,20220426000000[-6:CST]*-108.31*0**CITY OF AMES UT BILL 002819790003022,04/26/2022,CITY OF AMES UT BILL 002819790003022,,-108.31,,54432.81,,0.0,Bills & Utilities
1014,20220426000000[-6:CST]*-30.99*0**XX3498 POS PURCHASE AT WHISKEY RIVER (AM ES) AMES IA 00000001 211600145709,04/26/2022,XX3498 POS PURCHASE AT WHISKEY RIVER (AM ES) AMES IA 00000001 211600145709,,-30.99,,54541.12,,0.0,Food & Drink
1015,20220426000000[-6:CST]*-12.84*0**XX3498 POS PURCHASE AT PERFECT GAMES AME S IA 650000004025121 211600104301,04/26/2022,XX3498 POS PURCHASE AT PERFECT GAMES AME S IA 650000004025121 211600104301,,-12.84,,54572.11,,0.0,Entertainment
1016,20220425000000[-6:CST]*-2664.00*0**DHS CSRU IOW DHS IOWDHS011337057,04/25/2022,DHS CSRU IOW DHS IOWDHS011337057,,-2664.0,,54584.95,,0.0,Bills & Utilities
1017,20220425000000[-6:CST]*-440.64*0**FARMERS INS EFT PYMT mXXXXX5868,04/25/2022,FARMERS INS EFT PYMT mXXXXX5868,,-440.64,,57248.95,,0.0,Automotive
1018,20220425000000[-6:CST]*-0.29*0**DHS CSRU conv fee IOWDHS011337058,04/25/2022,DHS CSRU conv fee IOWDHS011337058,,-0.29,,57689.59,,0.0,Bills & Utilities
1019,20220425000000[-6:CST]*-200.00*0**XX3498 ATM WITHDRAWAL. 3334 LINCOLN WAY AMES IA 610013 064,04/25/2022,XX3498 ATM WITHDRAWAL. 3334 LINCOLN WAY AMES IA 610013 064,,-200.0,,57689.88,,0.0,Personal
1020,20220425000000[-6:CST]*-134.41*0**XX3498 POS WITHDRAWAL. HY VEE 1018 AMES IA 001 43292862,04/25/2022,XX3498 POS WITHDRAWAL. HY VEE 1018 AMES IA 001 43292862,,-134.41,,57889.88,,0.0,Groceries
1021,20220425000000[-6:CST]*-99.12*0**XX3498 POS WITHDRAWAL. HY VEE 1018 AMES IA 001 43293179,04/25/2022,XX3498 POS WITHDRAWAL. HY VEE 1018 AMES IA 001 43293179,,-99.12,,58024.29,,0.0,Groceries
1022,20220425000000[-6:CST]*-40.00*0**XX3498 POS PURCHASE AT SQ *ALLUVIAL BREW ING C Ames IA 372030000053360 211,04/25/2022,XX3498 POS PURCHASE AT SQ *ALLUVIAL BREW ING C Ames IA 372030000053360 211,,-40.0,,58123.41,,0.0,Food & Drink
1023,20220425000000[-6:CST]*-25.00*0**XX3498 POS WITHDRAWAL. WHEATSFIELD COO A MES IA 68087201 08725287,04/25/2022,XX3498 POS WITHDRAWAL. WHEATSFIELD COO A MES IA 68087201 08725287,,-25.0,,58163.41,,0.0,Groceries
1024,20220425000000[-6:CST]*-8.34*0**XX3498 POS PURCHASE AT B BOPS AMES NORTH AMES IA 650000011368068 21150010,04/25/2022,XX3498 POS PURCHASE AT B BOPS AMES NORTH AMES IA 650000011368068 21150010,,-8.34,,58188.41,,0.0,Food & Drink
1025,20220425000000[-6:CST]*-3.29*0**XX3498 POS WITHDRAWAL. KUMGO 1215 AMES AMES IA 001 00616284,04/25/2022,XX3498 POS WITHDRAWAL. KUM&GO 1215 AMES AMES IA 001 00616284,,-3.29,,58196.75,,0.0,Gas
1026,20220425000000[-6:CST]*-100.00*0**00675583 TRANSFER TO 780750 ON 4/23/22 A T 18:38,04/25/2022,00675583 TRANSFER TO 780750 ON 4/23/22 A T 18:38,,-100.0,,58200.04,,0.0,Personal
1027,20220421000000[-6:CST]*-119.77*0**Alliant - IPL PAYMENT 0061467186,04/21/2022,Alliant - IPL PAYMENT 0061467186,,-119.77,,58300.04,,0.0,Bills & Utilities
1028,20220421000000[-6:CST]*-41.05*0**XX3498 POS PURCHASE AT LA CASA MAYA AMES IA 519917920191558 211100082675,04/21/2022,XX3498 POS PURCHASE AT LA CASA MAYA AMES IA 519917920191558 211100082675,,-41.05,,58419.81,,0.0,Food & Drink
1029,20220420000000[-6:CST]*-40.00*0**XX3498 POS PURCHASE AT PERFECT GAMES AME S IA 650000004025121 211000093345,04/20/2022,XX3498 POS PURCHASE AT PERFECT GAMES AME S IA 650000004025121 211000093345,,-40.0,,58460.86,,0.0,Entertainment
1030,20220420000000[-6:CST]*-4.28*0**XX3498 POS PURCHASE AT PERFECT GAMES AME S IA 650000004025121 211000093353,04/20/2022,XX3498 POS PURCHASE AT PERFECT GAMES AME S IA 650000004025121 211000093353,,-4.28,,58500.86,,0.0,Entertainment
1031,20220419000000[-6:CST]*-200.00*0**XX3498 ATM WITHDRAWAL. 405 5TH ST AMES I A 619206 011,04/19/2022,XX3498 ATM WITHDRAWAL. 405 5TH ST AMES I A 619206 011,,-200.0,,58505.14,,0.0,Personal
1032,20220419000000[-6:CST]*-6.74*0**XX3498 POS WITHDRAWAL. HY VEE CLINIC 300 7 AMES IA 001 24791786,04/19/2022,XX3498 POS WITHDRAWAL. HY VEE CLINIC 300 7 AMES IA 001 24791786,,-6.74,,58705.14,,0.0,Groceries
1033,20220418000000[-6:CST]*-24.60*0**CLUB FEES PLANET FIT 515-620-8880,04/18/2022,CLUB FEES PLANET FIT 515-620-8880,,-24.6,,58711.88,,0.0,Personal
1034,20220418000000[-6:CST]*-65.10*0**XX3498 POS PURCHASE AT THE CAFE AMES IA 00000001 210800149916,04/18/2022,XX3498 POS PURCHASE AT THE CAFE AMES IA 00000001 210800149916,,-65.1,,58736.48,,0.0,Food & Drink
1035,20220418000000[-6:CST]*-43.95*0**XX3498 POS WITHDRAWAL. HY VEE 1013 AMES IA 001 23857415,04/18/2022,XX3498 POS WITHDRAWAL. HY VEE 1013 AMES IA 001 23857415,,-43.95,,58801.58,,0.0,Groceries
1036,20220418000000[-6:CST]*-42.79*0**XX3498 POS WITHDRAWAL. HY VEE 1018 AMES IA 001 23546299,04/18/2022,XX3498 POS WITHDRAWAL. HY VEE 1018 AMES IA 001 23546299,,-42.79,,58845.53,,0.0,Groceries
1037,20220418000000[-6:CST]*-23.40*0**XX3498 POS PURCHASE AT SQ *CORNBRED BARB ECUE AMES IA 372041000053360 2107,04/18/2022,XX3498 POS PURCHASE AT SQ *CORNBRED BARB ECUE AMES IA 372041000053360 2107,,-23.4,,58888.32,,0.0,Food & Drink
1038,20220418000000[-6:CST]*-20.00*0**XX3498 POS PURCHASE AT GOODWILL AMES AME S IA 9528 210700069265,04/18/2022,XX3498 POS PURCHASE AT GOODWILL AMES AME S IA 9528 210700069265,,-20.0,,58911.72,,0.0,Home
1039,20220418000000[-6:CST]*-7.37*0**XX3498 POS PURCHASE AT MCDONALD'S M2021 AMES IA 07637972021MDZ 2108000375,04/18/2022,XX3498 POS PURCHASE AT MCDONALD'S M2021 AMES IA 07637972021MDZ 2108000375,,-7.37,,58931.72,,0.0,Food & Drink
1040,20220418000000[-6:CST]*-100.00*0**00673420 TRANSFER TO 780750 ON 4/16/22 A T 16:16,04/18/2022,00673420 TRANSFER TO 780750 ON 4/16/22 A T 16:16,,-100.0,,58939.09,,0.0,Personal
1041,20220415000000[-6:CST]*-78.00*0**XX3498 POS WITHDRAWAL. WHEATSFIELD COO A MES IA 68087201 08724457,04/15/2022,XX3498 POS WITHDRAWAL. WHEATSFIELD COO A MES IA 68087201 08724457,,-78.0,,59039.09,,0.0,Groceries
1042,20220414000000[-6:CST]*-230.50*0**VERIZON WIRELESS PAYMENTS 05885909720000 1,04/14/2022,VERIZON WIRELESS PAYMENTS 05885909720000 1,,-230.5,,59117.09,,0.0,Bills & Utilities
1043,20220414000000[-6:CST]*-223.45*0**XX3498 POS WITHDRAWAL. HY VEE 1018 AMES IA 001 21680164,04/14/2022,XX3498 POS WITHDRAWAL. HY VEE 1018 AMES IA 001 21680164,,-223.45,,59347.59,,0.0,Groceries
1044,20220414000000[-6:CST]*-59.92*0**XX3498 POS PURCHASE AT SQ *CORNBRED BARB ECUE Ames IA 372041000053360 2104,04/14/2022,XX3498 POS PURCHASE AT SQ *CORNBRED BARB ECUE Ames IA 372041000053360 2104,,-59.92,,59571.04,,0.0,Food & Drink
1045,20220414000000[-6:CST]*-55.03*0**XX3498 POS PURCHASE AT Mucky Duck Pub Am es IA 513331030178305 21040004237,04/14/2022,XX3498 POS PURCHASE AT Mucky Duck Pub Am es IA 513331030178305 21040004237,,-55.03,,59630.96,,0.0,Food & Drink
1046,20220414000000[-6:CST]*3639.11*501**DONNELLEY FINANC DIRECT DEP 925022277146 L5Z,04/14/2022,DONNELLEY FINANC DIRECT DEP 925022277146 L5Z,,,3639.11,59685.99,,0.0,Deposit
1047,20220413000000[-6:CST]*-165.30*0**Alliant - IPL PAYMENT 3836938783,04/13/2022,Alliant - IPL PAYMENT 3836938783,,-165.3,,56046.88,,0.0,Bills & Utilities
1048,20220412000000[-6:CST]*3.74*501**Interest paid,04/12/2022,Interest paid,,,3.74,56212.18,,0.0,Deposit
1049,20220412000000[-6:CST]*-72.30*0**ASPEN WASTE SYST EFT PMT 8 00257691,04/12/2022,ASPEN WASTE SYST EFT PMT 8 00257691,,-72.3,,56208.44,,0.0,Bills & Utilities
1050,20220412000000[-6:CST]*-65.41*0**XX3498 POS PURCHASE AT PERFECT GAMES AME S IA 650000004025121 210200104022,04/12/2022,XX3498 POS PURCHASE AT PERFECT GAMES AME S IA 650000004025121 210200104022,,-65.41,,56280.74,,0.0,Entertainment
1051,20220412000000[-6:CST]*-32.10*0**XX3498 POS PURCHASE AT WILLIAMS-SONOMA 0 721 W DES MOINES IA 2692620001103,04/12/2022,XX3498 POS PURCHASE AT WILLIAMS-SONOMA 0 721 W DES MOINES IA 2692620001103,,-32.1,,56346.15,,0.0,Shopping
1052,20220412000000[-6:CST]*-24.00*0**XX3498 POS PURCHASE AT GOODWILL ANKENY A NKENY IA 9521 210200068110,04/12/2022,XX3498 POS PURCHASE AT GOODWILL ANKENY A NKENY IA 9521 210200068110,,-24.0,,56378.25,,0.0,Home
1053,20220412000000[-6:CST]*-6.42*0**XX3498 POS PURCHASE AT PERFECT GAMES AME S IA 650000004025121 210200104030,04/12/2022,XX3498 POS PURCHASE AT PERFECT GAMES AME S IA 650000004025121 210200104030,,-6.42,,56402.25,,0.0,Entertainment
1054,20220412000000[-6:CST]*-6.42*0**XX3498 POS PURCHASE AT PERFECT GAMES AME S IA 650000004025121 210200104037,04/12/2022,XX3498 POS PURCHASE AT PERFECT GAMES AME S IA 650000004025121 210200104037,,-6.42,,56408.67,,0.0,Entertainment
1055,20220411000000[-6:CST]*-200.00*0**XX3498 ATM WITHDRAWAL. 131 WELCH AVE AME S IA 610799 172,04/11/2022,XX3498 ATM WITHDRAWAL. 131 WELCH AVE AME S IA 610799 172,,-200.0,,56415.09,,0.0,Food & Drink
1056,20220411000000[-6:CST]*-129.79*0**XX3498 POS WITHDRAWAL. TRADER JOE'S #721 W DES MOINES IA 69472107 0722350,04/11/2022,XX3498 POS WITHDRAWAL. TRADER JOE'S #721 W DES MOINES IA 69472107 0722350,,-129.79,,56615.09,,0.0,Groceries
1057,20220411000000[-6:CST]*-122.00*0**XX3498 POS WITHDRAWAL. WHEATSFIELD COO A MES IA 68087201 08728427,04/11/2022,XX3498 POS WITHDRAWAL. WHEATSFIELD COO A MES IA 68087201 08728427,,-122.0,,56744.88,,0.0,Groceries
1058,20220411000000[-6:CST]*-10.37*0**XX3498 POS PURCHASE AT KWIK STOP LIQUOR  GRO AMES IA 650000008589650 210,04/11/2022,XX3498 POS PURCHASE AT KWIK STOP LIQUOR & GRO AMES IA 650000008589650 210,,-10.37,,56866.88,,0.0,Food & Drink
1059,20220411000000[-6:CST]*-9.60*0**XX3498 POS PURCHASE AT B BOPS AMES NORTH AMES IA 650000011368068 21000009,04/11/2022,XX3498 POS PURCHASE AT B BOPS AMES NORTH AMES IA 650000011368068 21000009,,-9.6,,56877.25,,0.0,Food & Drink
1060,20220411000000[-6:CST]*-8.56*0**XX3498 POS PURCHASE AT PERFECT GAMES AME S IA 650000004025121 210100107605,04/11/2022,XX3498 POS PURCHASE AT PERFECT GAMES AME S IA 650000004025121 210100107605,,-8.56,,56886.85,,0.0,Entertainment
1061,20220411000000[-6:CST]*-5.16*0**XX3498 POS WITHDRAWAL. FAREWAY STORES #3 86 AMES IA 92405701 96559400,04/11/2022,XX3498 POS WITHDRAWAL. FAREWAY STORES #3 86 AMES IA 92405701 96559400,,-5.16,,56895.41,,0.0,Groceries
1062,20220411000000[-6:CST]*-100.00*0**TRANSFER TO FREE CHECKING ACCOUNT XXXXXX 0750,04/11/2022,TRANSFER TO FREE CHECKING ACCOUNT XXXXXX 0750,,-100.0,,56900.57,,0.0,Personal
1063,20220406000000[-6:CST]*-944.37*0**CHASE CREDIT CRD AUTOPAY 000000000146337,04/06/2022,CHASE CREDIT CRD AUTOPAY 000000000146337,,-944.37,,57000.57,,0.0,Bills & Utilities
1064,20220406000000[-6:CST]*-200.00*0**XX3498 ATM WITHDRAWAL. 405 5TH ST AMES I A 610801 440,04/06/2022,XX3498 ATM WITHDRAWAL. 405 5TH ST AMES I A 610801 440,,-200.0,,57944.94,,0.0,Personal
1065,20220406000000[-6:CST]*-56.88*0**XX3498 POS PURCHASE AT PHILLIPS 66 - SWI FT ST AMES IA 650000005418358 209,04/06/2022,XX3498 POS PURCHASE AT PHILLIPS 66 - SWI FT ST AMES IA 650000005418358 209,,-56.88,,58144.94,,0.0,Gas
1066,20220406000000[-6:CST]*-54.50*0**XX3498 POS PURCHASE AT SQ *THE ANGRY IRI SHMEN Ames IA 372041000053360 209,04/06/2022,XX3498 POS PURCHASE AT SQ *THE ANGRY IRI SHMEN Ames IA 372041000053360 209,,-54.5,,58201.82,,0.0,Food & Drink
1067,20220406000000[-6:CST]*-31.48*0**XX3498 POS WITHDRAWAL. SWIFT STOP 5 AMES IA 00354J26 83,04/06/2022,XX3498 POS WITHDRAWAL. SWIFT STOP 5 AMES IA 00354J26 83,,-31.48,,58256.32,,0.0,Gas
1068,20220406000000[-6:CST]*-22.84*0**XX3498 POS PURCHASE AT SQ *CORNBRED BARB ECUE Ames IA 372041000053360 2096,04/06/2022,XX3498 POS PURCHASE AT SQ *CORNBRED BARB ECUE Ames IA 372041000053360 2096,,-22.84,,58287.8,,0.0,Food & Drink
1069,20220406000000[-6:CST]*-9.09*0**XX3498 POS PURCHASE AT Subway 20049 Ames IA 75135579 209600087936,04/06/2022,XX3498 POS PURCHASE AT Subway 20049 Ames IA 75135579 209600087936,,-9.09,,58310.64,,0.0,Food & Drink
1070,20220405000000[-6:CST]*-712.75*0**IOWA BANKERS MTG ACH PMT XXXXXX2430,04/05/2022,IOWA BANKERS MTG ACH PMT XXXXXX2430,,-712.75,,58319.73,,0.0,Home
1071,20220405000000[-6:CST]*-26.79*0**XX3498 POS WITHDRAWAL. FAREWAY STORES #3 86 AMES IA 92405701 46994600,04/05/2022,XX3498 POS WITHDRAWAL. FAREWAY STORES #3 86 AMES IA 92405701 46994600,,-26.79,,59032.48,,0.0,Groceries
1072,20220405000000[-6:CST]*-6.42*0**XX3498 POS PURCHASE AT PERFECT GAMES AME S IA 650000004025121 209500105439,04/05/2022,XX3498 POS PURCHASE AT PERFECT GAMES AME S IA 650000004025121 209500105439,,-6.42,,59059.27,,0.0,Entertainment
1073,20220404000000[-6:CST]*-80.00*0**XX3498 POS PURCHASE AT PERFECT GAMES AME S IA 650000004025121 209400063017,04/04/2022,XX3498 POS PURCHASE AT PERFECT GAMES AME S IA 650000004025121 209400063017,,-80.0,,59065.69,,0.0,Entertainment
1074,20220404000000[-6:CST]*-46.82*0**XX3498 POS PURCHASE AT PERFECT GAMES AME S IA 650000004025121 209400063013,04/04/2022,XX3498 POS PURCHASE AT PERFECT GAMES AME S IA 650000004025121 209400063013,,-46.82,,59145.69,,0.0,Entertainment
1075,20220404000000[-6:CST]*-43.20*0**XX3498 POS PURCHASE AT PHILLIPS 66 - SWI FT ST AMES IA 650000005418358 209,04/04/2022,XX3498 POS PURCHASE AT PHILLIPS 66 - SWI FT ST AMES IA 650000005418358 209,,-43.2,,59192.51,,0.0,Gas
1076,20220404000000[-6:CST]*-34.24*0**XX3498 POS PURCHASE AT PERFECT GAMES AME S IA 650000004025121 209400063016,04/04/2022,XX3498 POS PURCHASE AT PERFECT GAMES AME S IA 650000004025121 209400063016,,-34.24,,59235.71,,0.0,Entertainment
1077,20220401000000[-6:CST]*-40.00*0**VENMO PAYMENT 1019291462697,04/01/2022,VENMO PAYMENT 1019291462697,,-40.0,,59269.95,,0.0,Personal
1078,20220401000000[-6:CST]*-50.29*0**XX3498 POS PURCHASE AT SQ *CORNBRED BARB ECUE Ames IA 372041000053360 2091,04/01/2022,XX3498 POS PURCHASE AT SQ *CORNBRED BARB ECUE Ames IA 372041000053360 2091,,-50.29,,59309.95,,0.0,Food & Drink
1079,20220401000000[-6:CST]*3639.11*501**DONNELLEY FINANC DIRECT DEP 786082731796 L5Z,04/01/2022,DONNELLEY FINANC DIRECT DEP 786082731796 L5Z,,,3639.11,59360.24,,0.0,Deposit
1080,20220331000000[-6:CST]*-84.89*0**XX3498 POS PURCHASE AT Mucky Duck Pub Am es IA 513331030178305 20900005265,03/31/2022,XX3498 POS PURCHASE AT Mucky Duck Pub Am es IA 513331030178305 20900005265,,-84.89,,55721.13,,0.0,Food & Drink
1081,20220331000000[-6:CST]*-72.25*0**XX3498 POS PURCHASE AT SQ *THE ANGRY IRI SHMEN Ames IA 372041000053360 209,03/31/2022,XX3498 POS PURCHASE AT SQ *THE ANGRY IRI SHMEN Ames IA 372041000053360 209,,-72.25,,55806.02,,0.0,Food & Drink
1082,20220331000000[-6:CST]*-32.72*0**XX3498 POS PURCHASE AT Wal-Mart Super Ce nter AMES IA 07490050 90610928,03/31/2022,XX3498 POS PURCHASE AT Wal-Mart Super Ce nter AMES IA 07490050 90610928,,-32.72,,55878.27,,0.0,Groceries
1083,20220331000000[-6:CST]*-30.00*0**XX3498 POS PURCHASE AT MED*MCFARLAND CLI NIC AMES IA 384751000383010 20900,03/31/2022,XX3498 POS PURCHASE AT MED*MCFARLAND CLI NIC AMES IA 384751000383010 20900,,-30.0,,55910.99,,0.0,Health & Wellness
1084,20220331000000[-6:CST]*-25.00*0**XX3498 POS PURCHASE AT SQ *ACPS Ames IA 372041000053360 209000068436,03/31/2022,XX3498 POS PURCHASE AT SQ *ACPS Ames IA 372041000053360 209000068436,,-25.0,,55940.99,,0.0,Entertainment
1085,20220331000000[-6:CST]*-21.39*0**XX3498 POS WITHDRAWAL. T J MAXX 2701 GRA ND A AMES IA 95621001 19249774,03/31/2022,XX3498 POS WITHDRAWAL. T J MAXX 2701 GRA ND A AMES IA 95621001 19249774,,-21.39,,55965.99,,0.0,Shopping
1086,20220331000000[-6:CST]*-8.00*0**XX3498 POS PURCHASE AT GOODWILL AMES AME S IA 9528 209000056688,03/31/2022,XX3498 POS PURCHASE AT GOODWILL AMES AME S IA 9528 209000056688,,-8.0,,55987.38,,0.0,Home
1087,20220330000000[-6:CST]*-4.16*0**XX3498 POS PURCHASE AT MCDONALD'S M2021 AMES IA 81545304 37276400,03/30/2022,XX3498 POS PURCHASE AT MCDONALD'S M2021 AMES IA 81545304 37276400,,-4.16,,55995.38,,0.0,Food & Drink
1088,20220329000000[-6:CST]*-47.50*0**XX3498 POS PURCHASE AT PERFECT GAMES AME S IA 650000004025121 208800097860,03/29/2022,XX3498 POS PURCHASE AT PERFECT GAMES AME S IA 650000004025121 208800097860,,-47.5,,55999.54,,0.0,Entertainment
1089,20220328000000[-6:CST]*-94.13*0**CITY OF AMES UT BILL 002629810006826,03/28/2022,CITY OF AMES UT BILL 002629810006826,,-94.13,,56047.04,,0.0,Bills & Utilities
1090,20220328000000[-6:CST]*-200.00*0**XX3498 ATM WITHDRAWAL. 2406 GRAND AVE AM ES IA 612292 157,03/28/2022,XX3498 ATM WITHDRAWAL. 2406 GRAND AVE AM ES IA 612292 157,,-200.0,,56141.17,,0.0,Personal
1091,20220328000000[-6:CST]*-197.80*0**XX3498 POS WITHDRAWAL. HY VEE 1018 AMES IA 001 37650022,03/28/2022,XX3498 POS WITHDRAWAL. HY VEE 1018 AMES IA 001 37650022,,-197.8,,56341.17,,0.0,Groceries
1092,20220328000000[-6:CST]*-67.29*0**XX3498 POS WITHDRAWAL. WAL-MART #749 AME S IA 600001 00036355,03/28/2022,XX3498 POS WITHDRAWAL. WAL-MART #749 AME S IA 600001 00036355,,-67.29,,56538.97,,0.0,Groceries
1093,20220328000000[-6:CST]*-29.00*0**XX3498 POS PURCHASE AT SQ *LONDON UNDERG ROUND Ames IA 372030000053360 208,03/28/2022,XX3498 POS PURCHASE AT SQ *LONDON UNDERG ROUND Ames IA 372030000053360 208,,-29.0,,56606.26,,0.0,Food & Drink
1094,20220328000000[-6:CST]*218.00*501**IASTTAXRFD IASTTAXRFD 000000000000000,03/28/2022,IASTTAXRFD IASTTAXRFD 000000000000000,,,218.0,56635.26,,0.0,Deposit
1095,20220325000000[-6:CST]*-120.00*0**XX3498 ATM WITHDRAWAL. 119 MAIN ST AMES IA RT35199 00008746,03/25/2022,XX3498 ATM WITHDRAWAL. 119 MAIN ST AMES IA RT35199 00008746,,-120.0,,56417.26,,0.0,Personal
1096,20220325000000[-6:CST]*-35.33*0**XX3498 POS PURCHASE AT SQ *CORNBRED BARB ECUE Ames IA 372041000053360 2084,03/25/2022,XX3498 POS PURCHASE AT SQ *CORNBRED BARB ECUE Ames IA 372041000053360 2084,,-35.33,,56537.26,,0.0,Food & Drink
1097,20220325000000[-6:CST]*-3.49*0**ATM WITHDRAWAL FEE XX3498 ATM WITHDRAWAL . 119 MAIN ST AMES IA RT35199 00008746,03/25/2022,ATM WITHDRAWAL FEE XX3498 ATM WITHDRAWAL . 119 MAIN ST AMES IA RT35199 00008746,,-3.49,,56572.59,,0.0,Personal
1098,20220324000000[-6:CST]*-102.01*0**CITY OF AMES UT BILL 002819790003022,03/24/2022,CITY OF AMES UT BILL 002819790003022,,-102.01,,56576.08,,0.0,Bills & Utilities
1099,20220324000000[-6:CST]*-62.99*0**XX3498 POS PURCHASE AT THE CAFE AMES IA 00000001 208300086421,03/24/2022,XX3498 POS PURCHASE AT THE CAFE AMES IA 00000001 208300086421,,-62.99,,56678.09,,0.0,Food & Drink
1100,20220324000000[-6:CST]*-8.31*0**XX3498 POS WITHDRAWAL. CASEYS GEN STORE AMES IA 600001 00025023,03/24/2022,XX3498 POS WITHDRAWAL. CASEYS GEN STORE AMES IA 600001 00025023,,-8.31,,56741.08,,0.0,Gas
1101,20220323000000[-6:CST]*-2664.00*0**DHS CSRU IOW DHS IOWDHS011204584,03/23/2022,DHS CSRU IOW DHS IOWDHS011204584,,-2664.0,,56749.39,,0.0,Bills & Utilities
1102,20220323000000[-6:CST]*-440.62*0**FARMERS INS EFT PYMT mXXXXX5868,03/23/2022,FARMERS INS EFT PYMT mXXXXX5868,,-440.62,,59413.39,,0.0,Automotive
1103,20220323000000[-6:CST]*-0.29*0**DHS CSRU conv fee IOWDHS011204585,03/23/2022,DHS CSRU conv fee IOWDHS011204585,,-0.29,,59854.01,,0.0,Bills & Utilities
1104,20220323000000[-6:CST]*-81.83*0**XX3498 POS PURCHASE AT JCPENNEY 0384 AME S IA 0000 208200093050,03/23/2022,XX3498 POS PURCHASE AT JCPENNEY 0384 AME S IA 0000 208200093050,,-81.83,,59854.3,,0.0,Home
1105,20220322000000[-6:CST]*-39.00*0**XX3498 POS WITHDRAWAL. WHEATSFIELD COO A MES IA 68087201 08721669,03/22/2022,XX3498 POS WITHDRAWAL. WHEATSFIELD COO A MES IA 68087201 08721669,,-39.0,,59936.13,,0.0,Groceries
1106,20220322000000[-6:CST]*-3.75*0**XX3498 POS PURCHASE AT SUPER SHINE AMES AMES IA 4445029735099 20810010167,03/22/2022,XX3498 POS PURCHASE AT SUPER SHINE AMES AMES IA 4445029735099 20810010167,,-3.75,,59975.13,,0.0,Automotive
1107,20220321000000[-6:CST]*-165.61*0**Alliant - IPL PAYMENT 0061467186,03/21/2022,Alliant - IPL PAYMENT 0061467186,,-165.61,,59978.88,,0.0,Bills & Utilities
1108,20220321000000[-6:CST]*-200.00*0**XX3498 ATM WITHDRAWAL. 3725 STANGE ROAD AMES IA 5719G113 245,03/21/2022,XX3498 ATM WITHDRAWAL. 3725 STANGE ROAD AMES IA 5719G113 245,,-200.0,,60144.49,,0.0,Personal
1109,20220321000000[-6:CST]*-65.00*0**XX3498 POS PURCHASE AT O DONNELL ACE HAR DWARE AMES IA 7137 208000066474,03/21/2022,XX3498 POS PURCHASE AT O DONNELL ACE HAR DWARE AMES IA 7137 208000066474,,-65.0,,60344.49,,0.0,Home
1110,20220321000000[-6:CST]*-23.91*0**XX3498 POS PURCHASE AT SQ *CORNBRED BARB ECUE Ames IA 372041000053360 2078,03/21/2022,XX3498 POS PURCHASE AT SQ *CORNBRED BARB ECUE Ames IA 372041000053360 2078,,-23.91,,60409.49,,0.0,Food & Drink
1111,20220321000000[-6:CST]*-20.00*0**XX3498 POS PURCHASE AT HABITAT FOR HUMAN ITY O AMES IA 91365901 2079000017,03/21/2022,XX3498 POS PURCHASE AT HABITAT FOR HUMAN ITY O AMES IA 91365901 2079000017,,-20.0,,60433.4,,0.0,Home
1112,20220321000000[-6:CST]*-8.76*0**XX3498 POS PURCHASE AT MCDONALD'S M2021 AMES IA 81545304 66048200,03/21/2022,XX3498 POS PURCHASE AT MCDONALD'S M2021 AMES IA 81545304 66048200,,-8.76,,60453.4,,0.0,Food & Drink
1113,20220321000000[-6:CST]*-8.12*0**XX3498 POS PURCHASE AT B BOPS AMES NORTH AMES IA 650000011368068 20780011,03/21/2022,XX3498 POS PURCHASE AT B BOPS AMES NORTH AMES IA 650000011368068 20780011,,-8.12,,60462.16,,0.0,Food & Drink
1114,20220318000000[-6:CST]*3639.10*501**DONNELLEY FINANC DIRECT DEP 000216282415 L5Z,03/18/2022,DONNELLEY FINANC DIRECT DEP 000216282415 L5Z,,,3639.1,60470.28,,0.0,Deposit
1115,20220317000000[-6:CST]*-1618.25*0**COUNTY TREASURER TAX 3236581,03/17/2022,COUNTY TREASURER TAX 3236581,,-1618.25,,56831.18,,0.0,Home
1116,20220317000000[-6:CST]*-24.60*0**CLUB FEES PLANET FIT 515-620-8880,03/17/2022,CLUB FEES PLANET FIT 515-620-8880,,-24.6,,58449.43,,0.0,Personal
1117,20220317000000[-6:CST]*-38.54*0**XX3498 POS PURCHASE AT SQ *CORNBRED BARB ECUE Ames IA 372041000053360 2076,03/17/2022,XX3498 POS PURCHASE AT SQ *CORNBRED BARB ECUE Ames IA 372041000053360 2076,,-38.54,,58474.03,,0.0,Food & Drink
1118,20220317000000[-6:CST]*-16.26*0**XX3498 POS PURCHASE AT KWIK STOP LIQUOR  GRO AMES IA 650000008589650 207,03/17/2022,XX3498 POS PURCHASE AT KWIK STOP LIQUOR & GRO AMES IA 650000008589650 207,,-16.26,,58512.57,,0.0,Food & Drink
1119,20220317000000[-6:CST]*-200.00*0**00348008 TRANSFER TO 780750 ON 3/16/22 A T 20:24,03/17/2022,00348008 TRANSFER TO 780750 ON 3/16/22 A T 20:24,,-200.0,,58528.83,,0.0,Personal
1120,20220316000000[-6:CST]*-230.50*0**VERIZON WIRELESS PAYMENTS 05885909720000 1,03/16/2022,VERIZON WIRELESS PAYMENTS 05885909720000 1,,-230.5,,58728.83,,0.0,Bills & Utilities
1121,20220316000000[-6:CST]*-55.53*0**XX3498 POS WITHDRAWAL. Wal-Mart Super Ce nter AMES IA 07490046 97538911,03/16/2022,XX3498 POS WITHDRAWAL. Wal-Mart Super Ce nter AMES IA 07490046 97538911,,-55.53,,58959.33,,0.0,Groceries
1122,20220316000000[-6:CST]*-20.00*0**XX3498 POS WITHDRAWAL. HY VEE CLINIC 300 7 AMES IA 001 08054221,03/16/2022,XX3498 POS WITHDRAWAL. HY VEE CLINIC 300 7 AMES IA 001 08054221,,-20.0,,59014.86,,0.0,Groceries
1123,20220315000000[-6:CST]*-41.89*0**XX3498 POS PURCHASE AT CASEYS #3424 ELLE NDALE MN 4445022003424 2074000512,03/15/2022,XX3498 POS PURCHASE AT CASEYS #3424 ELLE NDALE MN 4445022003424 2074000512,,-41.89,,59034.86,,0.0,Gas
1124,20220315000000[-6:CST]*-40.00*0**XX3498 POS PURCHASE AT PERFECT GAMES AME S IA 650000004025121 207400101864,03/15/2022,XX3498 POS PURCHASE AT PERFECT GAMES AME S IA 650000004025121 207400101864,,-40.0,,59076.75,,0.0,Entertainment
1125,20220315000000[-6:CST]*13400.10*501**DONNELLEY FINANC DIRECT DEP 706087840493 L5Z,03/15/2022,DONNELLEY FINANC DIRECT DEP 706087840493 L5Z,,,13400.1,59116.75,,0.0,Deposit
1126,20220314000000[-6:CST]*-223.10*0**Alliant - IPL PAYMENT 3836938783,03/14/2022,Alliant - IPL PAYMENT 3836938783,,-223.1,,45716.65,,0.0,Bills & Utilities
1127,20220314000000[-6:CST]*-24.00*0**XX3498 POS PURCHASE AT MILL CITY MUSEUM MINNEAPOLIS MN 92269226 207100164,03/14/2022,XX3498 POS PURCHASE AT MILL CITY MUSEUM MINNEAPOLIS MN 92269226 207100164,,-24.0,,45939.75,,0.0,Travel
1128,20220314000000[-6:CST]*-16.54*0**XX3498 POS PURCHASE AT OUTLET ST.PAUL CA MPUS SAINT PAUL MN 0905 207200060,03/14/2022,XX3498 POS PURCHASE AT OUTLET ST.PAUL CA MPUS SAINT PAUL MN 0905 207200060,,-16.54,,45963.75,,0.0,Travel
1129,20220314000000[-6:CST]*-14.01*0**XX3498 POS PURCHASE AT TST* Farmers Kitc hen  Minneapolis MN 394992000256,03/14/2022,XX3498 POS PURCHASE AT TST* Farmers Kitc hen & Minneapolis MN 394992000256,,-14.01,,45980.29,,0.0,Travel
1130,20220314000000[-6:CST]*-12.24*0**XX3498 POS WITHDRAWAL. CASEYS GEN STORE ELLENDALE MN 600001 00051969,03/14/2022,XX3498 POS WITHDRAWAL. CASEYS GEN STORE ELLENDALE MN 600001 00051969,,-12.24,,45994.3,,0.0,Gas
